RD,TS_received,TS_sent,AK,RoundTrip,
37681,42797,2023-11-20_23-51-46-089603,42800,5116,
42800,0,,47901,-42800,
47903,53015,2023-11-20_23-51-56-987265,53024,5112,
53036,0,,58156,-53036,
58157,63287,2023-11-20_23-52-09-395313,63290,5130,
63291,68410,2023-11-20_23-52-13-329643,68413,5119,
68413,73538,2023-11-20_23-52-17-295577,73540,5125,
73541,
78637,
83746,0,,88856,-83746,
88856,93969,2023-11-20_23-52-40-174171,93972,5113,
93973,
99104,104220,2023-11-20_23-52-51-355678,104223,5116,
104223,109343,2023-11-20_23-52-56-029227,109346,5120,
109347,114453,2023-11-20_23-53-01-666324,114456,5106,
114456,119568,2023-11-20_23-53-06-326881,119578,5112,
119590,
124679,129795,2023-11-20_23-53-16-838661,129798,5116,
129798,134916,2023-11-20_23-53-22-232132,134925,5118,
134937,140044,2023-11-20_23-53-27-851503,140046,5107,
140047,
145163,150317,2023-11-20_23-53-37-972217,150320,5154,
150320,155431,2023-11-20_23-53-43-375397,155434,5111,
155434,
160545,165698,2023-11-20_23-53-53-398595,165701,5153,
165701,
170830,
175938,181055,2023-11-20_23-54-08-838744,181064,5117,
181076,186194,2023-11-20_23-54-14-793366,186203,5118,
186215,0,,191329,-186215,
191341,
196466,
201574,
206730,211846,2023-11-20_23-54-41-077908,211855,5116,
211867,216954,2023-11-20_23-54-46-117423,216957,5087,
216957,
222069,227186,2023-11-20_23-54-56-733448,227195,5117,
227208,232334,2023-11-20_23-55-02-071079,232343,5126,
232355,0,,237455,-232355,
237455,242579,2023-11-20_23-55-12-250010,242581,5124,
242582,247693,2023-11-20_23-55-17-458683,247696,5111,
247696,252801,2023-11-20_23-55-22-667264,252804,5105,
252804,257912,2023-11-20_23-55-27-455420,257916,5108,
257916,263022,2023-11-20_23-55-32-671512,263025,5106,
263025,268129,2023-11-20_23-55-38-305486,268132,5104,
268132,
273229,278358,2023-11-20_23-55-48-702969,278367,5129,
278380,283492,2023-11-20_23-55-54-246585,283496,5112,
283496,288603,2023-11-20_23-55-59-512517,288605,5107,
288606,0,,293710,-288606,
293711,298848,2023-11-20_23-56-09-849932,298851,5137,
298851,303955,2023-11-20_23-56-14-760207,303964,5104,
303977,0,,309057,-303977,
309057,314210,2023-11-20_23-56-25-451335,314213,5153,
314213,319317,2023-11-20_23-56-30-640151,319326,5104,
319338,324466,2023-11-20_23-56-35-628711,324475,5128,
324487,
329594,334711,2023-11-20_23-56-46-627194,334721,5117,
334733,
339810,
344918,
350026,355142,2023-11-20_23-57-07-814784,355151,5116,
355163,360278,2023-11-20_23-57-12-711931,360287,5115,
360299,
365408,0,,370524,-365408,
370525,
375630,
380738,
385846,390963,2023-11-20_23-57-44-316691,390965,5117,
390966,396071,2023-11-20_23-57-49-773553,396073,5105,
396074,401193,2023-11-20_23-57-54-710373,401201,5119,
401213,406300,2023-11-20_23-58-00-132934,406303,5087,
406303,411442,2023-11-20_23-58-04-948538,411451,5139,
411463,416549,2023-11-20_23-58-10-505732,416552,5086,
416553,421877,2023-11-20_23-58-15-938109,421879,5324,
421880,
426995,0,,432111,-426995,
432123,437232,2023-11-20_23-58-32-243892,437235,5109,
437235,442333,2023-11-20_23-58-36-971207,442343,5098,
442355,447476,2023-11-20_23-58-41-855103,447480,5121,
447480,452606,2023-11-20_23-58-47-676182,452614,5126,
452627,457742,2023-11-20_23-58-53-207845,457745,5115,
457745,462852,2023-11-20_23-58-57-873130,462855,5107,
462856,467978,2023-11-20_23-59-02-968435,467987,5122,
467999,473129,2023-11-20_23-59-08-221516,473132,5130,
473132,478266,2023-11-20_23-59-13-781501,478269,5134,
478269,483385,2023-11-20_23-59-18-633612,483388,5116,
483389,
488496,
493604,
498712,
503820,
508949,514064,2023-11-20_23-59-50-586573,514067,5115,
514068,
519165,
524281,
529389,534505,2023-11-21_00-00-11-657426,534508,5116,
534508,539616,2023-11-21_00-00-15-946586,539625,5108,
539636,544741,2023-11-21_00-00-22-128312,544745,5105,
544745,
549858,
554966,560081,2023-11-21_00-00-36-950408,560084,5115,
560086,565210,2023-11-21_00-00-42-675598,565219,5124,
565232,
570323,
575431,
656571,661687,2023-11-21_00-02-19-352032,661690,5116,
661691,
666792,671908,2023-11-21_00-02-31-747456,671911,5116,
671911,677026,2023-11-21_00-02-36-776586,677029,5115,
677029,
682143,
687266,
692376,697494,2023-11-21_00-02-58-091933,697503,5118,
697515,702631,2023-11-21_00-03-03-362670,702634,5116,
702634,707741,2023-11-21_00-03-08-572407,707744,5107,
707744,712864,2023-11-21_00-03-13-850769,712867,5120,
712868,0,,717976,-712868,
717977,723090,2023-11-21_00-03-22-205481,723093,5113,
723093,728250,2023-11-21_00-03-29-712207,728260,5157,
728272,733357,2023-11-21_00-03-34-193633,733359,5085,
733360,
738457,743573,2023-11-21_00-03-44-707582,743576,5116,
743576,
748673,
753784,
758892,764010,2023-11-21_00-04-06-239526,764018,5118,
764030,
769128,774246,2023-11-21_00-04-16-220942,774248,5118,
774249,779371,2023-11-21_00-04-22-119574,779373,5122,
779374,784478,2023-11-21_00-04-27-279802,784481,5104,
784481,
789592,
794700,799841,2023-11-21_00-04-42-809092,799843,5141,
799844,804949,2023-11-21_00-04-47-658605,804952,5105,
804954,810084,2023-11-21_00-04-52-559802,810092,5130,
810104,
815178,820294,2023-11-21_00-05-03-380475,820296,5116,
820297,825414,2023-11-21_00-05-09-297583,825417,5117,
825417,830545,2023-11-21_00-05-13-699375,830548,5128,
830548,
835643,
840751,845867,2023-11-21_00-05-28-083861,845870,5116,
845870,850981,2023-11-21_00-05-35-821096,850983,5111,
850984,856102,2023-11-21_00-05-40-903880,856111,5118,
856122,861237,2023-11-21_00-05-45-736654,861246,5115,
861258,
866336,871468,2023-11-21_00-05-55-937387,871472,5132,
871472,
876574,
881682,886797,2023-11-21_00-06-11-910951,886800,5115,
886801,
891915,
897023,902139,2023-11-21_00-06-27-652905,902142,5116,
902143,907259,2023-11-21_00-06-33-210294,907267,5116,
907278,912389,2023-11-21_00-06-37-833274,912392,5111,
912392,917507,2023-11-21_00-06-43-136872,917510,5115,
917510,922634,2023-11-21_00-06-47-627512,922643,5124,
922655,
927757,
932865,
937973,
943081,
978903,0,,984044,-978903,
984048,
989144,994260,2023-11-21_00-08-01-217488,994270,5116,
994282,