RD,TS_received,TS_sent,AK,RoundTrip,
339949,345052,2022-10-24_15-30-22-778713,345063,5103,
345075,345096,2022-10-24_15-30-27-912506,345099,21,
350160,355273,2022-10-24_15-30-33-223689,355282,5113,
355294,355316,2022-10-24_15-30-38-372102,355318,22,
360412,360483,2022-10-24_15-30-43-668621,360486,71,
365554,370669,2022-10-24_15-30-48-993690,370678,5115,
370691,370711,2022-10-24_15-30-54-135130,370714,20,
375788,380905,2022-10-24_15-30-59-463341,380914,5117,
380926,381000,2022-10-24_15-31-04-660433,381002,74,
386015,386035,2022-10-24_15-31-09-817190,386038,20,
391137,391255,2022-10-24_15-31-15-139927,396280,118,
396292,396311,2022-10-24_15-31-20-333834,396314,19,
401419,406532,2022-10-24_15-31-25-653588,406547,5113,
406569,406619,2022-10-24_15-31-30-876090,406622,50,
411635,416741,2022-10-24_15-31-36-303325,416754,5106,
416775,416865,2022-10-24_15-31-41-354242,416869,90,
421859,421927,2022-10-24_15-31-46-543957,421930,68,
426965,432097,2022-10-24_15-31-51-766097,432110,5132,
432123,432230,2022-10-24_15-31-57-056743,437204,107,
437220,442311,2022-10-24_15-32-02-415026,442320,5091,
442332,442352,2022-10-24_15-32-07-445586,442355,20,
447422,452543,2022-10-24_15-32-12-801684,452552,5121,
452572,452653,2022-10-24_15-32-17-982170,452656,81,
457686,457763,2022-10-24_15-32-23-207511,457768,77,
462797,467919,2022-10-24_15-32-28-527965,467935,5122,
467949,473059,2022-10-24_15-32-33-755149,473068,5110,
473083,473162,2022-10-24_15-32-38-969607,473165,79,
478180,478201,2022-10-24_15-32-44-140541,478204,21,
483297,488434,2022-10-24_15-32-49-519887,488443,5137,
488456,493576,2022-10-24_15-32-54-742948,493592,5120,
493613,498692,2022-10-24_15-33-00-068480,498707,5079,
498727,498763,2022-10-24_15-33-05-187704,498766,36,
503804,503867,2022-10-24_15-33-10-415164,503870,63,
508912,508966,2022-10-24_15-33-15-635762,508969,54,
514056,519163,2022-10-24_15-33-20-957780,519173,5107,
519185,524303,2022-10-24_15-33-26-384476,524319,5118,
524340,529411,2022-10-24_15-33-31-607827,529426,5071,
529448,529479,2022-10-24_15-33-36-625297,529481,31,
534516,534537,2022-10-24_15-33-41-796620,534540,21,
539664,539687,2022-10-24_15-33-47-070510,539690,23,
544788,549920,2022-10-24_15-33-52-395407,549936,5132,
549957,555028,2022-10-24_15-33-57-720140,555043,5071,
555064,560129,2022-10-24_15-34-02-941107,560137,5065,
560149,560194,2022-10-24_15-34-08-062226,560197,45,
565249,570376,2022-10-24_15-34-13-387491,570386,5127,
570399,570419,2022-10-24_15-34-18-531981,570423,20,
575478,580595,2022-10-24_15-34-23-860138,580603,5117,
580616,585721,2022-10-24_15-34-29-259164,585730,5105,
585750,590831,2022-10-24_15-34-34-341955,590848,5081,
590868,595935,2022-10-24_15-34-39-601823,595945,5067,
595957,596015,2022-10-24_15-34-44-721748,596017,58,
601056,
606151,611275,2022-10-24_15-34-55-167452,611283,5124,
611296,611318,2022-10-24_15-35-00-389757,611321,22,
616411,616432,2022-10-24_15-35-05-621828,616435,21,
621555,626660,2022-10-24_15-35-10-938356,626670,5105,
626686,626724,2022-10-24_15-35-16-160015,626727,38,
631780,631837,2022-10-24_15-35-21-382285,631840,57,
636891,636936,2022-10-24_15-35-26-605994,636939,45,
641991,647104,2022-10-24_15-35-31-829200,647119,5113,
647134,647155,2022-10-24_15-35-37-053450,647158,21,
652217,652255,2022-10-24_15-35-42-272617,652258,38,
657335,657361,2022-10-24_15-35-47-494694,657365,26,
662450,662472,2022-10-24_15-35-52-722103,662474,22,
667575,667597,2022-10-24_15-35-57-971379,667600,22,
672697,677804,2022-10-24_15-36-03-367471,677812,5107,
677832,682911,2022-10-24_15-36-08-591354,682920,5079,
682932,682978,2022-10-24_15-36-13-711268,682981,46,
688036,688074,2022-10-24_15-36-18-927379,688077,38,
693143,693193,2022-10-24_15-36-24-156114,693198,50,
698252,698290,2022-10-24_15-36-29-379190,698295,38,
703374,703397,2022-10-24_15-36-34-610300,703400,23,
708494,708513,2022-10-24_15-36-39-840427,708516,19,
713642,713701,2022-10-24_15-36-45-148588,713706,59,
718775,718798,2022-10-24_15-36-50-364347,718801,23,
723882,729001,2022-10-24_15-36-55-693962,729010,5119,
729022,729102,2022-10-24_15-37-00-913042,729105,80,
734136,734201,2022-10-24_15-37-06-131624,734204,65,
739238,739310,2022-10-24_15-37-11-360562,739312,72,
744370,744413,2022-10-24_15-37-16-579662,744416,43,
749494,749519,2022-10-24_15-37-21-806414,749524,25,
754619,754638,2022-10-24_15-37-27-048308,754641,19,
759745,759813,2022-10-24_15-37-32-346550,759816,68,
764851,764871,2022-10-24_15-37-37-520931,764874,20,
769972,769994,2022-10-24_15-37-42-758518,769997,22,
775084,775104,2022-10-24_15-37-47-987859,775107,20,
780204,780224,2022-10-24_15-37-53-227766,780227,20,
785329,785349,2022-10-24_15-37-58-467234,785351,20,
790451,790470,2022-10-24_15-38-03-709798,790474,19,
795559,795581,2022-10-24_15-38-08-937899,795584,22,
800686,800751,2022-10-24_15-38-14-236709,800757,65,
805824,805856,2022-10-24_15-38-19-460016,805860,32,
810950,810970,2022-10-24_15-38-24-697994,810973,20,
816061,816081,2022-10-24_15-38-29-925134,816084,20,
821171,821192,2022-10-24_15-38-35-156629,821194,21,
826280,826300,2022-10-24_15-38-40-382783,826302,20,
831394,831475,2022-10-24_15-38-45-665473,831478,81,
836540,836584,2022-10-24_15-38-50-899865,836587,44,
841676,841696,2022-10-24_15-38-56-133276,841699,20,
846789,846809,2022-10-24_15-39-01-360439,846812,20,
851918,851992,2022-10-24_15-39-06-666587,851997,74,
857025,857092,2022-10-24_15-39-11-888870,857097,67,
862126,862145,2022-10-24_15-39-17-058795,862148,19,
867268,867291,2022-10-24_15-39-22-332164,867294,23,
872375,872398,2022-10-24_15-39-27-551338,872401,23,
877509,877529,2022-10-24_15-39-32-808009,877532,20,
882617,882665,2022-10-24_15-39-38-066569,882669,48,
887724,892840,2022-10-24_15-39-43-419480,892843,5116,
892843,892863,2022-10-24_15-39-48-503559,892867,20,
897960,897993,2022-10-24_15-39-53-761558,897996,33,
903069,903172,2022-10-24_15-39-59-055509,903175,103,
908213,908235,2022-10-24_15-40-04-239255,908237,22,
913363,913416,2022-10-24_15-40-09-543974,913421,53,
918469,918503,2022-10-24_15-40-14-753358,918505,34,
923579,923614,2022-10-24_15-40-19-984387,923617,35,
928686,928728,2022-10-24_15-40-25-222432,928731,42,
933795,933819,2022-10-24_15-40-30-430345,933822,24,
938936,939010,2022-10-24_15-40-35-748522,939013,74,
944043,944112,2022-10-24_15-40-40-971316,944115,69,
949155,949218,2022-10-24_15-40-46-192415,949221,63,
954263,954328,2022-10-24_15-40-51-423948,954330,65,
959365,959385,2022-10-24_15-40-56-597563,959388,20,
964480,964531,2022-10-24_15-41-01-860999,964534,51,
969588,969632,2022-10-24_15-41-07-080495,969635,44,
974696,974745,2022-10-24_15-41-12-311756,974748,49,
979797,979817,2022-10-24_15-41-17-504890,979820,20,
984914,984950,2022-10-24_15-41-22-752854,984954,36,
990012,990034,2022-10-24_15-41-27-958471,990036,22,
995129,995161,2022-10-24_15-41-33-204065,995164,32,
1000238,1000265,2022-10-24_15-41-38-427228,1000272,27,
1005360,1005452,2022-10-24_15-41-43-740249,1005455,92,
1010462,1010487,2022-10-24_15-41-48-893177,1010490,25,
1015578,1015675,2022-10-24_15-41-54-193982,1015678,97,
1020694,1020714,2022-10-24_15-41-59-356874,1020717,20,
1025812,1025884,2022-10-24_15-42-04-631320,1025887,72,
1030909,1030929,2022-10-24_15-42-09-805217,1030932,20,
1036060,1036098,2022-10-24_15-42-15-090538,1036103,38,
1041197,1041216,2022-10-24_15-42-20-328948,1041219,19,
1046305,1046327,2022-10-24_15-42-25-560736,1046330,22,
1051456,1051502,2022-10-24_15-42-30-857273,1051507,46,
1056564,1056588,2022-10-24_15-42-36-067690,1056591,24,
1061696,1061717,2022-10-24_15-42-41-320908,1061720,21,
1066814,1066834,2022-10-24_15-42-46-564783,1066837,20,
1071922,1071945,2022-10-24_15-42-51-794238,1071948,23,
1077029,1077049,2022-10-24_15-42-57-025823,1077052,20,
1082157,1082190,2022-10-24_15-43-02-286437,1082193,33,
1087286,1087308,2022-10-24_15-43-07-520427,1087310,22,
1092419,1092440,2022-10-24_15-43-12-776011,1092443,21,
1097536,1097564,2022-10-24_15-43-18-012143,1097567,28,
1102659,0,,1107788,-1102659,
1107803,1107836,2022-10-24_15-43-28-518262,1107840,33,
1112939,1113015,2022-10-24_15-43-33-826554,1113018,76,
1118047,1118070,2022-10-24_15-43-39-001699,1118073,23,
1123335,1123429,2022-10-24_15-43-44-482733,1123433,94,
1128436,1128496,2022-10-24_15-43-49-668661,1128499,60,
1133553,1133572,2022-10-24_15-43-54-868950,1133577,19,
1138671,1138692,2022-10-24_15-44-00-107666,1138695,21,
1143805,1143845,2022-10-24_15-44-05-376390,1143850,40,
1148911,1148943,2022-10-24_15-44-10-601746,1148946,32,
1154029,1154047,2022-10-24_15-44-15-825718,1154050,18,
1159233,1159253,2022-10-24_15-44-21-153035,1159255,20,
1164367,1164446,2022-10-24_15-44-26-466146,1164450,79,
1169512,1169616,2022-10-24_15-44-31-755126,1174636,104,
1174648,1174667,2022-10-24_15-44-36-932867,1174671,19,
1179739,1179760,2022-10-24_15-44-42-143858,1179762,21,
1184851,1184941,2022-10-24_15-44-47-448150,1184944,90,
1189978,1190044,2022-10-24_15-44-52-672907,1190048,66,
1195116,1195154,2022-10-24_15-44-57-904998,1195157,38,
1200246,1200265,2022-10-24_15-45-03-137683,1200269,19,
1205377,1205465,2022-10-24_15-45-08-454867,1205470,88,
1210504,1210553,2022-10-24_15-45-13-669245,1210556,49,
1215603,1215623,2022-10-24_15-45-18-859433,1215627,20,
1220722,1220755,2022-10-24_15-45-24-113091,1220759,33,
1225852,1225873,2022-10-24_15-45-29-351248,1225876,21,
1230977,1230999,2022-10-24_15-45-34-595398,1231002,22,
1236094,1236114,2022-10-24_15-45-39-827582,1236117,20,
1241211,0,,1246324,-1241211,
1246336,1246356,2022-10-24_15-45-50-312979,1246359,20,
1251467,1251486,2022-10-24_15-45-55-561614,1251489,19,
1256590,1256611,2022-10-24_15-46-00-809896,1256614,21,
1261713,1261735,2022-10-24_15-46-06-055220,1261737,22,
1266835,1266897,2022-10-24_15-46-11-331044,1266902,62,
1271980,1272004,2022-10-24_15-46-16-561445,1272008,24,
1277137,1277158,2022-10-24_15-46-21-837654,1277160,21,
1282284,1282313,2022-10-24_15-46-27-116823,1282316,29,
1287398,1287462,2022-10-24_15-46-32-385550,1287465,64,
1292513,1292588,2022-10-24_15-46-37-633281,1292592,75,
1297614,1297702,2022-10-24_15-46-42-864097,1297705,88,
1302723,1302743,2022-10-24_15-46-48-037305,1302746,20,
1307832,1307851,2022-10-24_15-46-53-259942,1307855,19,
1312990,1313011,2022-10-24_15-46-58-543700,1313014,21,
1318125,1318144,2022-10-24_15-47-03-799571,1318147,19,
1323271,1323304,2022-10-24_15-47-09-074075,1323306,33,
1328370,1328388,2022-10-24_15-47-14-281758,1328391,18,
1333510,1333530,2022-10-24_15-47-19-541962,1333533,20,
1338672,1338720,2022-10-24_15-47-24-845034,1338723,48,
1343779,1343823,2022-10-24_15-47-30-075287,1343826,44,
1348877,1348897,2022-10-24_15-47-35-264424,1348900,20,
1354019,1354038,2022-10-24_15-47-40-525004,1354042,19,
1359143,1359163,2022-10-24_15-47-45-770067,1359166,20,
1364249,1364345,2022-10-24_15-47-51-063753,1364348,96,
1369373,1369394,2022-10-24_15-47-56-239260,1369397,21,
1374491,1374533,2022-10-24_15-48-01-501302,1374535,42,
1379589,1379635,2022-10-24_15-48-06-694331,1379639,46,
1384706,1384784,2022-10-24_15-48-11-989519,1384787,78,
1389916,1389950,2022-10-24_15-48-17-278971,1389953,34,
1395016,1395036,2022-10-24_15-48-22-483447,1395039,20,
1400151,1400170,2022-10-24_15-48-27-742332,1400173,19,
1405256,1405361,2022-10-24_15-48-33-048325,1410380,105,
1410401,1410475,2022-10-24_15-48-38-278446,1410479,74,
1415484,1415505,2022-10-24_15-48-43-445649,1415508,21,
1420592,1420614,2022-10-24_15-48-48-671754,1420617,22,
1425720,1425773,2022-10-24_15-48-53-942871,1425778,53,
1430819,1430839,2022-10-24_15-48-59-140892,1430842,20,
1435962,1435981,2022-10-24_15-49-04-399859,1435984,19,
1441120,1441179,2022-10-24_15-49-09-717835,1441182,59,
1446226,1446282,2022-10-24_15-49-14-935196,1446285,56,
1451326,1451347,2022-10-24_15-49-20-123535,1451350,21,
1456477,1456498,2022-10-24_15-49-25-395188,1456501,21,
1461584,1461611,2022-10-24_15-49-30-629162,1461614,27,
1466729,1466773,2022-10-24_15-49-35-910429,1466777,44,
1471821,0,,1471911,-1471821,
1476946,1476989,2022-10-24_15-49-46-374457,1476992,43,
1482053,1482092,2022-10-24_15-49-51-589861,1482097,39,
1487188,1487218,2022-10-24_15-49-56-844959,1487221,30,
1492296,1492348,2022-10-24_15-50-02-097934,1492350,52,
1497406,1497489,2022-10-24_15-50-07-363575,1497492,83,
1502532,1502600,2022-10-24_15-50-12-587953,1502605,68,
1507662,1507686,2022-10-24_15-50-17-798421,1507689,24,
1512795,1512825,2022-10-24_15-50-23-039598,1512830,30,
1517909,1517930,2022-10-24_15-50-28-279613,1517934,21,
1523031,1523051,2022-10-24_15-50-33-523603,1523055,20,
1528147,1528188,2022-10-24_15-50-38-759332,1528192,41,
1533270,1533304,2022-10-24_15-50-44-014224,1533307,34,
1538378,1538407,2022-10-24_15-50-49-232884,1538410,29,
1543492,1543533,2022-10-24_15-50-54-487635,1543536,41,
1548598,1548618,2022-10-24_15-50-59-700710,1548621,20,
1553709,1553730,2022-10-24_15-51-04-928889,1553733,21,
1558828,1558849,2022-10-24_15-51-10-171773,1558852,21,
1563973,1564027,2022-10-24_15-51-15-466573,1564030,54,
1569118,1569137,2022-10-24_15-51-20-698379,1569141,19,
1574231,1574251,2022-10-24_15-51-25-933791,1574254,20,
1579366,1579441,2022-10-24_15-51-31-245817,1579443,75,
1584498,1584520,2022-10-24_15-51-36-444091,1584523,22,
1589628,1589647,2022-10-24_15-51-41-685094,1589650,19,
1594786,1594869,2022-10-24_15-51-47-033945,1594872,83,
1599912,1599954,2022-10-24_15-51-52-226611,1599959,42,
1605032,1605061,2022-10-24_15-51-57-451066,1605066,29,
1610143,1610231,2022-10-24_15-52-02-759108,1610235,88,
1615263,1615288,2022-10-24_15-52-07-934645,1615291,25,
1620368,1620458,2022-10-24_15-52-13-226677,1620461,90,
1625492,1625564,2022-10-24_15-52-18-448481,1625567,72,
1630621,1630662,2022-10-24_15-52-23-660491,1630667,41,
1635766,1635787,2022-10-24_15-52-28-909288,1635790,21,
1640879,1640899,2022-10-24_15-52-34-144727,1640903,20,
1645985,1646006,2022-10-24_15-52-39-366325,1646009,21,
1651102,1651166,2022-10-24_15-52-44-651406,1651169,64,
1656236,1656279,2022-10-24_15-52-49-879960,1656284,43,
1661384,1661406,2022-10-24_15-52-55-131932,1661409,22,
1666523,1666584,2022-10-24_15-53-00-433403,1666588,61,
1671667,1671689,2022-10-24_15-53-05-658309,1671692,22,
1676794,1676814,2022-10-24_15-53-10-907060,1676817,20,
1681914,1681985,2022-10-24_15-53-16-196834,1681987,71,
1687038,1687085,2022-10-24_15-53-21-417279,1687090,47,
1692147,1692175,2022-10-24_15-53-26-631327,1692178,28,
1697247,1697286,2022-10-24_15-53-31-858560,1697289,39,
1702364,1702390,2022-10-24_15-53-37-081829,1702393,26,
1707464,1707488,2022-10-24_15-53-42-305242,1707491,24,
1712613,1712704,2022-10-24_15-53-47-629823,1712707,91,
1717711,1717732,2022-10-24_15-53-52-784619,1717736,21,
1722818,1722838,2022-10-24_15-53-58-010889,1722841,20,
1727959,1727982,2022-10-24_15-54-03-276877,1727985,23,
1733102,1733150,2022-10-24_15-54-08-571837,1733154,48,
1738216,1738240,2022-10-24_15-54-13-775672,1738244,24,
1743371,1743395,2022-10-24_15-54-19-058205,1743398,24,
1748479,1748514,2022-10-24_15-54-24-294766,1748517,35,
1753587,1753612,2022-10-24_15-54-29-513637,1753615,25,
1758693,1758821,2022-10-24_15-54-34-829920,1763842,128,
1763864,1763942,2022-10-24_15-54-40-086526,1763945,78,
1768966,1769083,2022-10-24_15-54-45-320107,1774067,117,
1774088,1774137,2022-10-24_15-54-50-507460,1774140,49,
1779198,1779221,2022-10-24_15-54-55-725561,1779224,23,
1784349,1784369,2022-10-24_15-55-00-996229,1784372,20,
1789460,1789536,2022-10-24_15-55-06-272286,1789541,76,
1794567,1794624,2022-10-24_15-55-11-497019,1794627,57,
1799675,1799726,2022-10-24_15-55-16-719619,1799728,51,
1804783,1804840,2022-10-24_15-55-21-934790,1804846,57,
1809890,1809939,2022-10-24_15-55-27-161626,1809942,49,
1815021,1815044,2022-10-24_15-55-32-388627,1815048,23,
1820134,1820164,2022-10-24_15-55-37-625004,1820167,30,
1825277,1825339,2022-10-24_15-55-42-924193,1825342,62,
1830374,1830397,2022-10-24_15-55-48-095559,1830400,23,
1835530,1835556,2022-10-24_15-55-53-384286,1835559,26,
1840680,1840750,2022-10-24_15-55-58-691039,1840753,70,
1845812,1850906,2022-10-24_15-56-04-121954,1850909,5094,
1850909,1850931,2022-10-24_15-56-09-122297,1850933,22,
1856064,1856091,2022-10-24_15-56-14-398834,1856094,27,
1861219,1861264,2022-10-24_15-56-19-682267,1861267,45,
1866309,1866329,2022-10-24_15-56-24-870671,1866332,20,
1871460,1871485,2022-10-24_15-56-30-142295,1871490,25,
1876568,1876589,2022-10-24_15-56-35-374977,1876594,21,
1881673,1881693,2022-10-24_15-56-40-597083,1881696,20,
1886817,1886842,2022-10-24_15-56-45-860072,1886845,25,
1891934,1891980,2022-10-24_15-56-51-122044,1891984,46,
1897067,1897100,2022-10-24_15-56-56-357820,1897102,33,
1902198,1902270,2022-10-24_15-57-01-662682,1902273,72,
1907299,1907323,2022-10-24_15-57-06-829951,1907326,24,
1912420,1912448,2022-10-24_15-57-12-067786,1912451,28,
1917538,1917598,2022-10-24_15-57-17-349342,1917601,60,
1922682,1922718,2022-10-24_15-57-22-573191,1922721,36,
1927814,1927900,2022-10-24_15-57-27-883732,1927904,86,
1932922,1932942,2022-10-24_15-57-33-044845,1932945,20,
1938047,1938124,2022-10-24_15-57-38-344192,1938126,77,
1943155,1943234,2022-10-24_15-57-43-561600,1943239,79,
1948303,1948323,2022-10-24_15-57-48-786672,1948326,20,
1953424,1953449,2022-10-24_15-57-54-036462,1953452,25,
1958550,1958611,2022-10-24_15-57-59-322940,1958619,61,
1963654,1963731,2022-10-24_15-58-04-555113,1963734,77,
1968757,1968777,2022-10-24_15-58-09-718359,1968780,20,
1973864,1973887,2022-10-24_15-58-14-938776,1973890,23,
1978986,1979066,2022-10-24_15-58-20-229986,1979071,80,
1984095,1984127,2022-10-24_15-58-25-417369,1984130,32,
1989202,1989247,2022-10-24_15-58-30-658201,1989250,45,
1994335,1994362,2022-10-24_15-58-35-891927,1994367,27,
1999452,1999472,2022-10-24_15-58-41-124628,1999475,20,
2004576,2004645,2022-10-24_15-58-46-424434,2004648,69,
2009703,2009780,2022-10-24_15-58-51-663281,2009785,77,
2014844,2014866,2022-10-24_15-58-56-879765,2014870,22,
2020064,2020084,2022-10-24_15-59-02-221125,2020086,20,
2025195,2025264,2022-10-24_15-59-07-519019,2025267,69,
2030311,2030375,2022-10-24_15-59-12-753544,2030378,64,
2035434,2035487,2022-10-24_15-59-17-968001,2035490,53,
2040570,2045688,2022-10-24_15-59-23-416251,2045693,5118,
2045693,2045791,2022-10-24_15-59-28-529098,2045794,98,
2050807,2050882,2022-10-24_15-59-33-735337,2050886,75,
2055906,2055993,2022-10-24_15-59-38-968649,2055999,87,
2061029,2061051,2022-10-24_15-59-44-153399,2061054,22,
2066177,2066201,2022-10-24_15-59-49-415979,2066203,24,
2071297,2071323,2022-10-24_15-59-54-659685,2071326,26,
2076425,2076445,2022-10-24_15-59-59-904497,2076449,20,
2081548,2081620,2022-10-24_16-00-05-198791,2081623,72,
2086673,2086702,2022-10-24_16-00-10-397443,2086704,29,
2091781,2091811,2022-10-24_16-00-15-628421,2091813,30,
2096921,2096940,2022-10-24_16-00-20-884593,2096944,19,
2102051,2102136,2022-10-24_16-00-26-184193,2102141,85,
2107151,2107172,2022-10-24_16-00-31-348487,2107175,21,
2112268,2112314,2022-10-24_16-00-36-610645,2112318,46,
2117377,2117424,2022-10-24_16-00-41-845940,2117427,47,
2122483,2122519,2022-10-24_16-00-47-057224,2122522,36,
2127576,2127628,2022-10-24_16-00-52-286894,2127631,52,
2132713,2132734,2022-10-24_16-00-57-513786,2132737,21,
2137819,2137839,2022-10-24_16-01-02-743862,2137842,20,
2142940,2142960,2022-10-24_16-01-07-977035,2142964,20,
2148047,2148070,2022-10-24_16-01-13-207621,2148073,23,
2153188,2153207,2022-10-24_16-01-18-461966,2153210,19,
2158304,2158372,2022-10-24_16-01-23-724037,2158375,68,
2163445,2163476,2022-10-24_16-01-28-956879,2163481,31,
2168552,2168645,2022-10-24_16-01-34-262438,2168648,93,
2173667,2173746,2022-10-24_16-01-39-483767,2173750,79,
2178771,2178857,2022-10-24_16-01-44-706423,2178860,86,
2183884,2183905,2022-10-24_16-01-49-879054,2183909,21,
2189000,2189052,2022-10-24_16-01-55-152279,2189055,52,
2194108,2194164,2022-10-24_16-02-00-374977,2194167,56,
2199220,2199290,2022-10-24_16-02-05-613420,2199296,70,
2204327,2204382,2022-10-24_16-02-10-829453,2204386,55,
2209436,2209478,2022-10-24_16-02-16-042255,2209481,42,
2214542,2214598,2022-10-24_16-02-21-277027,2214603,56,
2219655,2219701,2022-10-24_16-02-26-498891,2219706,46,
2224763,2224797,2022-10-24_16-02-31-722544,2224803,34,
2229870,2229908,2022-10-24_16-02-36-953572,2229911,38,
2235007,2235026,2022-10-24_16-02-42-195551,2235029,19,
2240157,2240195,2022-10-24_16-02-47-488156,2240199,38,
2245266,2245303,2022-10-24_16-02-52-709698,2245308,37,
2250365,2250385,2022-10-24_16-02-57-911618,2250389,20,
2255514,2255533,2022-10-24_16-03-03-179577,2255536,19,
2260621,2260713,2022-10-24_16-03-08-479607,2260717,92,
2265741,2265819,2022-10-24_16-03-13-703747,2265825,78,
2270846,2275967,2022-10-24_16-03-19-027851,2275983,5121,
2276002,2276026,2022-10-24_16-03-24-149364,2276028,24,
2281080,2286201,2022-10-24_16-03-29-472846,2286212,5121,
2286224,2291327,2022-10-24_16-03-34-695448,2291337,5103,
2291341,2296444,2022-10-24_16-03-40-122132,2296453,5103,
2296472,2301607,2022-10-24_16-03-45-242559,2301622,5135,
2301635,2306717,2022-10-24_16-03-50-464609,2306735,5082,
2306757,2311823,2022-10-24_16-03-55-789951,2311832,5066,
2311844,2311883,2022-10-24_16-04-00-848656,2311886,39,
2316953,2322066,2022-10-24_16-04-06-132772,2322082,5113,
2322105,2327167,2022-10-24_16-04-11-457449,2327176,5062,
2327197,2327254,2022-10-24_16-04-16-578494,2327256,57,
2332287,2332354,2022-10-24_16-04-21-800445,2332356,67,
2337395,2342534,2022-10-24_16-04-27-022432,2342543,5139,
2342555,2342576,2022-10-24_16-04-32-267320,2342579,21,
2347692,2352806,2022-10-24_16-04-37-672306,2352820,5114,
2352842,2352959,2022-10-24_16-04-42-822789,2357907,117,
2357919,2357959,2022-10-24_16-04-48-014685,2357963,40,
2363050,2368165,2022-10-24_16-04-53-339843,2368174,5115,
2368186,2368310,2022-10-24_16-04-58-594958,2373302,124,
2373314,2378449,2022-10-24_16-05-03-787358,2378465,5135,
2378483,2378588,2022-10-24_16-05-09-111568,2383549,105,
2383564,2388662,2022-10-24_16-05-14-332049,2388671,5098,
2388689,2388709,2022-10-24_16-05-19-475009,2388712,20,
2393773,2398910,2022-10-24_16-05-24-846141,2398920,5137,
2398932,2398991,2022-10-24_16-05-29-999346,2398994,59,
2404072,2409196,2022-10-24_16-05-35-325242,2409211,5124,
2409223,2414340,2022-10-24_16-05-40-546221,2414355,5117,
2414377,2419449,2022-10-24_16-05-45-871829,2419463,5072,
2419486,2424556,2022-10-24_16-05-51-095137,2424572,5070,
2424592,2429662,2022-10-24_16-05-56-377568,2429678,5070,
2429696,2434772,2022-10-24_16-06-01-641096,2434788,5076,
2434804,2439873,2022-10-24_16-06-06-863382,2439882,5069,
2439894,2439923,2022-10-24_16-06-11-881888,2439925,29,
2445003,2445034,2022-10-24_16-06-17-113321,2445037,31,
2450123,2450215,2022-10-24_16-06-22-420397,2450218,92,
2455252,2460370,2022-10-24_16-06-27-754206,2460385,5118,
2460406,2465477,2022-10-24_16-06-32-978956,2465492,5071,
2465513,2470584,2022-10-24_16-06-38-142016,2470599,5071,
2470618,2475692,2022-10-24_16-06-43-523259,2475708,5074,
2475727,2475747,2022-10-24_16-06-48-550640,2475749,20,
2480838,2480874,2022-10-24_16-06-53-796845,2480877,36,
2485971,2491093,2022-10-24_16-06-59-186950,2491102,5122,
2491114,2491136,2022-10-24_16-07-04-301640,2491140,22,
2496236,2496262,2022-10-24_16-07-09-544601,2496265,26,
2501356,2506472,2022-10-24_16-07-14-858807,2506488,5116,
2506509,2511571,2022-10-24_16-07-20-184774,2511585,5062,
2511605,2511658,2022-10-24_16-07-25-304359,2511660,53,
2516694,2521795,2022-10-24_16-07-30-630729,2521805,5101,
2521824,2521881,2022-10-24_16-07-35-752114,2521887,57,
2526925,2532053,2022-10-24_16-07-41-075606,2532061,5128,
2532074,2537190,2022-10-24_16-07-46-297944,2537205,5116,
2537226,2542296,2022-10-24_16-07-51-578457,2542312,5070,
2542332,2542369,2022-10-24_16-07-56-743841,2542373,37,
2547412,2552513,2022-10-24_16-08-02-067653,2552529,5101,
2552551,2552578,2022-10-24_16-08-07-188210,2552581,27,
2557652,2557685,2022-10-24_16-08-12-410939,2557688,33,
2562782,2562883,2022-10-24_16-08-17-735283,2562886,101,
2567884,2567907,2022-10-24_16-08-22-877813,2567910,23,
2573028,2573051,2022-10-24_16-08-28-145211,2573053,23,
2578145,2578187,2022-10-24_16-08-33-401177,2578190,42,
2583245,2583285,2022-10-24_16-08-38-624902,2583289,40,
2588394,2588414,2022-10-24_16-08-43-868329,2588418,20,
2593550,2598671,2022-10-24_16-08-49-274840,2598685,5121,
2598706,2598798,2022-10-24_16-08-54-496622,2598801,92,
2603806,2603827,2022-10-24_16-08-59-636951,2603830,21,
2608914,2608934,2022-10-24_16-09-04-863748,2608937,20,
2614035,2619180,2022-10-24_16-09-10-169932,2619189,5145,
2619201,2624324,2022-10-24_16-09-15-488570,2624339,5123,
2624359,2624410,2022-10-24_16-09-20-700350,2624413,51,
2629432,2629453,2022-10-24_16-09-25-853554,2629456,21,
2634539,2634561,2022-10-24_16-09-31-084659,2634564,22,
2639679,2639732,2022-10-24_16-09-36-378862,2639735,53,
2644797,2649905,2022-10-24_16-09-41-703679,2649913,5108,
2649926,2655015,2022-10-24_16-09-47-027728,2655030,5089,
2655052,2660120,2022-10-24_16-09-52-250446,2660133,5068,
2660154,2665257,2022-10-24_16-09-57-473503,2665266,5103,
2665278,2665334,2022-10-24_16-10-02-592656,2665337,56,
2670374,2675488,2022-10-24_16-10-07-918750,2675497,5114,
2675516,2675558,2022-10-24_16-10-13-042994,2675560,42,
2680612,2685750,2022-10-24_16-10-18-365208,2685759,5138,
2685771,2690881,2022-10-24_16-10-23-721471,2690897,5110,
2690919,2690966,2022-10-24_16-10-28-808023,2690968,47,
2695994,2701119,2022-10-24_16-10-34-134037,2701135,5125,
2701149,2701168,2022-10-24_16-10-39-256133,2701171,19,
2706222,2706268,2022-10-24_16-10-44-476765,2706271,46,
2711340,2711372,2022-10-24_16-10-49-698002,2711375,32,
2716432,2721552,2022-10-24_16-10-55-174022,2721561,5120,
2721572,2721600,2022-10-24_16-11-00-166859,2721603,28,
2726680,2726781,2022-10-24_16-11-05-467330,2726785,101,
2731804,2736950,2022-10-24_16-11-10-689260,2736963,5146,
2736974,2742085,2022-10-24_16-11-16-017681,2742098,5111,
2742120,2742198,2022-10-24_16-11-21-237138,2742201,78,
2747229,2752345,2022-10-24_16-11-26-563461,2752361,5116,
2752378,2757454,2022-10-24_16-11-31-784273,2757470,5076,
2757487,2762561,2022-10-24_16-11-37-030581,2762576,5074,
2762592,2767669,2022-10-24_16-11-42-331655,2767684,5077,
2767697,2772813,2022-10-24_16-11-47-452498,2772828,5116,
2772849,2772907,2022-10-24_16-11-52-674640,2772909,58,
2777919,2783034,2022-10-24_16-11-57-895583,2783050,5115,
2783072,2788136,2022-10-24_16-12-03-221813,2788151,5064,
2788163,2793250,2022-10-24_16-12-08-341902,2793266,5087,
2793287,2798380,2022-10-24_16-12-13-666008,2798390,5093,
2798402,2798424,2022-10-24_16-12-18-787739,2798427,22,
2803519,2803540,2022-10-24_16-12-24-028106,2803544,21,
2808623,2808731,2022-10-24_16-12-29-334224,2813735,108,
2813749,2813841,2022-10-24_16-12-34-561565,2813844,92,
2818881,2818926,2022-10-24_16-12-39-779219,2818929,45,
2823999,2824035,2022-10-24_16-12-45-001503,2824038,36,
2829116,2829141,2022-10-24_16-12-50-224646,2829143,25,
2834239,2834260,2022-10-24_16-12-55-470851,2834263,21,
2839349,2844455,2022-10-24_16-13-00-771264,2844463,5106,
2844482,2844556,2022-10-24_16-13-05-995361,2844559,74,
2849565,2849586,2022-10-24_16-13-11-143739,2849589,21,
2854691,2859813,2022-10-24_16-13-16-542035,2859828,5122,
2859848,2859875,2022-10-24_16-13-21-671037,2859878,27,
2864926,2870029,2022-10-24_16-13-27-091984,2870044,5103,
2870061,2875140,2022-10-24_16-13-32-311520,2875149,5079,
2875166,2880252,2022-10-24_16-13-37-532947,2880261,5086,
2880272,2880292,2022-10-24_16-13-42-571640,2880295,20,
2885392,2890515,2022-10-24_16-13-47-977205,2890530,5123,
2890551,2895621,2022-10-24_16-13-53-201669,2895637,5070,
2895659,2900730,2022-10-24_16-13-58-612875,2900745,5071,
2900759,2900782,2022-10-24_16-14-03-544640,2900785,23,
2905876,2910983,2022-10-24_16-14-08-874156,2910993,5107,
2911007,2916126,2022-10-24_16-14-14-251512,2916142,5119,
2916164,2916206,2022-10-24_16-14-19-320211,2916212,42,
2921240,2921300,2022-10-24_16-14-24-536070,2921303,60,
2926385,2926408,2022-10-24_16-14-29-761090,2926411,23,
2931509,2931529,2022-10-24_16-14-35-004500,2931532,20,
2936667,2941802,2022-10-24_16-14-40-408398,2941818,5135,
2941839,2941901,2022-10-24_16-14-45-622204,2941905,62,
2946908,2952026,2022-10-24_16-14-50-853043,2952036,5118,
2952039,2957160,2022-10-24_16-14-56-177396,2957176,5121,
2957195,2957231,2022-10-24_16-15-01-312904,2957234,36,
2962263,2962344,2022-10-24_16-15-06-543738,2962347,81,
2967380,2967429,2022-10-24_16-15-11-746710,2967434,49,
2972489,2972526,2022-10-24_16-15-16-957510,2972529,37,
2977592,2977633,2022-10-24_16-15-22-188863,2977636,41,
2982725,2982748,2022-10-24_16-15-27-419933,2982751,23,
2987830,2987852,2022-10-24_16-15-32-647544,2987855,22,
2993012,2998129,2022-10-24_16-15-38-060278,2998137,5117,
2998154,2998256,2022-10-24_16-15-43-281819,2998259,102,
3003270,3003290,2022-10-24_16-15-48-451098,3003293,20,
3008386,3008446,2022-10-24_16-15-53-728724,3008451,60,
3013494,3018609,2022-10-24_16-15-59-018874,3018625,5115,
3018646,3018754,2022-10-24_16-16-04-276140,3023717,108,
3023736,3023761,2022-10-24_16-16-09-395292,3023764,25,
3028831,3028869,2022-10-24_16-16-14-616946,3028872,38,
3033939,3033965,2022-10-24_16-16-19-831082,3033968,26,
3039080,3039100,2022-10-24_16-16-25-084180,3039103,20,
3044181,3044200,2022-10-24_16-16-30-308496,3044203,19,
3049308,3049328,2022-10-24_16-16-35-556710,3049331,20,
3054416,3054436,2022-10-24_16-16-40-786790,3054439,20,
3059540,3059564,2022-10-24_16-16-46-037904,3059573,24,
3064657,3064684,2022-10-24_16-16-51-276318,3064686,27,
3069766,3074892,2022-10-24_16-16-56-567661,3074900,5126,
3074913,3080004,2022-10-24_16-17-01-928160,3080019,5091,
3080041,3080098,2022-10-24_16-17-07-048403,3080100,57,
3085112,3085132,2022-10-24_16-17-12-193129,3085135,20,
3090219,3090239,2022-10-24_16-17-17-413579,3090242,20,
3095364,3095417,2022-10-24_16-17-22-714016,3095421,53,
3100480,3105604,2022-10-24_16-17-28-042177,3105618,5124,
3105630,3105649,2022-10-24_16-17-33-184917,3105652,19,
3110708,3115815,2022-10-24_16-17-38-484867,3115824,5107,
3115844,3115926,2022-10-24_16-17-43-706851,3115929,82,
3120946,3120966,2022-10-24_16-17-48-866436,3120969,20,
3126060,3131167,2022-10-24_16-17-54-255182,3131176,5107,
3131196,3131245,2022-10-24_16-17-59-372908,3131250,49,
3136288,3141412,2022-10-24_16-18-04-702420,3141422,5124,
3141434,3146519,2022-10-24_16-18-09-921820,3146530,5085,
3146549,3146653,2022-10-24_16-18-15-145319,3146655,104,
3151623,3156743,2022-10-24_16-18-20-367161,3156752,5120,
3156755,3161860,2022-10-24_16-18-25-590948,3161869,5105,
3161888,3161959,2022-10-24_16-18-30-812442,3161965,71,
3167012,3172137,2022-10-24_16-18-36-137602,3172152,5125,
3172164,3172185,2022-10-24_16-18-41-282140,3172187,21,
3177291,3182425,2022-10-24_16-18-46-684675,3182436,5134,
3182449,3182560,2022-10-24_16-18-51-895738,3187566,111,
3187577,3192685,2022-10-24_16-18-57-254156,3192695,5108,
3192707,3192768,2022-10-24_16-19-02-352411,3192771,61,
3197845,3197869,2022-10-24_16-19-07-574111,3197872,24,
3202975,3203001,2022-10-24_16-19-12-821813,3203005,26,
3208084,3213194,2022-10-24_16-19-18-121329,3213210,5110,
3213230,3218304,2022-10-24_16-19-23-446319,3218319,5074,
3218339,3218373,2022-10-24_16-19-28-566492,3218376,34,
3223414,3228543,2022-10-24_16-19-33-891449,3228557,5129,
3228568,3228589,2022-10-24_16-19-39-018366,3228592,21,
3233654,3238779,2022-10-24_16-19-44-326412,3238788,5125,
3238801,3238822,2022-10-24_16-19-49-491125,3238824,21,
3243922,3243943,2022-10-24_16-19-54-731083,3243946,21,
3249040,3254157,2022-10-24_16-20-00-080172,3254173,5117,
3254187,3254207,2022-10-24_16-20-05-230741,3254210,20,
3259269,3259302,2022-10-24_16-20-10-448872,3259306,33,
3264386,3264414,2022-10-24_16-20-15-672026,3264416,28,
3269509,3269611,2022-10-24_16-20-20-996930,3269614,102,
3274620,0,,3279736,-3274620,
3279736,3284846,2022-10-24_16-20-31-544590,3284856,5110,
3284872,3289955,2022-10-24_16-20-36-697978,3289964,5083,
3289983,3290023,2022-10-24_16-20-41-884891,3290027,40,
3295114,3295138,2022-10-24_16-20-47-120210,3295140,24,
3300228,3300250,2022-10-24_16-20-52-359163,3300253,22,
3305336,3305356,2022-10-24_16-20-57-584210,3305359,20,
3310455,3315570,2022-10-24_16-21-02-980478,3315585,5115,
3315607,3320678,2022-10-24_16-21-08-203489,3320694,5071,
3320715,3320742,2022-10-24_16-21-13-323654,3320745,27,
3325791,3325848,2022-10-24_16-21-18-546699,3325851,57,
3330899,3330937,2022-10-24_16-21-23-759278,3330940,38,
3336054,3336073,2022-10-24_16-21-29-018314,3336076,19,
3341182,3346300,2022-10-24_16-21-34-418223,3346316,5118,
3346335,3351408,2022-10-24_16-21-39-640908,3351421,5073,
3351434,3351454,2022-10-24_16-21-44-765991,3351456,20,
3356519,3361617,2022-10-24_16-21-50-091429,3361626,5098,
3361644,3366725,2022-10-24_16-21-55-409654,3366734,5081,
3366755,3371835,2022-10-24_16-22-00-633052,3371845,5080,
3371857,3371877,2022-10-24_16-22-05-675011,3371879,20,
3376980,3382094,2022-10-24_16-22-10-976849,3382111,5114,
3382132,3387200,2022-10-24_16-22-16-300784,3387216,5068,
3387237,3392309,2022-10-24_16-22-21-522989,3392324,5072,
3392347,3397417,2022-10-24_16-22-26-744538,3397433,5070,
3397454,3402550,2022-10-24_16-22-32-071161,3402562,5096,
3402573,3402594,2022-10-24_16-22-37-099568,3402597,21,
3407665,3407787,2022-10-24_16-22-42-413391,3412783,122,
3412804,3412891,2022-10-24_16-22-47-635560,3412894,87,
3417905,3423018,2022-10-24_16-22-52-857748,3423033,5113,
3423053,3423100,2022-10-24_16-22-58-082924,3423102,47,
3428128,3433271,2022-10-24_16-23-03-404478,3433283,5143,
3433295,3433316,2022-10-24_16-23-08-541947,3433319,21,
3438387,3443508,2022-10-24_16-23-13-849891,3443517,5121,
3443529,3443551,2022-10-24_16-23-19-007708,3443554,22,
3448619,3448642,2022-10-24_16-23-24-224601,3448644,23,
3453767,3458883,2022-10-24_16-23-29-620056,3458892,5116,
3458904,3458926,2022-10-24_16-23-34-749583,3458928,22,
3463995,3464014,2022-10-24_16-23-39-966997,3464017,19,
3469129,3474259,2022-10-24_16-23-45-491809,3474264,5130,
3474264,3479352,2022-10-24_16-23-50-612316,3479367,5088,
3479390,3484460,2022-10-24_16-23-55-834851,3484474,5070,
3484494,3489568,2022-10-24_16-24-01-056442,3489583,5074,
3489605,3494677,2022-10-24_16-24-06-279916,3494693,5072,
3494711,3499779,2022-10-24_16-24-11-604732,3499794,5068,
3499815,3499837,2022-10-24_16-24-16-622958,3499840,22,
3504896,3504942,2022-10-24_16-24-21-845400,3504946,46,
3510005,3515144,2022-10-24_16-24-27-170052,3515153,5139,
3515165,3520269,2022-10-24_16-24-32-392239,3520277,5104,
3520296,3525411,2022-10-24_16-24-37-717866,3525427,5115,
3525442,3525461,2022-10-24_16-24-42-846208,3525464,19,
3530523,3535627,2022-10-24_16-24-48-161964,3535640,5104,
3535653,3540756,2022-10-24_16-24-53-384295,3540764,5103,
3540776,3545897,2022-10-24_16-24-58-607391,3545913,5121,
3545934,3550997,2022-10-24_16-25-03-883399,3551007,5063,
3551020,3551069,2022-10-24_16-25-09-051746,3551071,49,
3556119,3561254,2022-10-24_16-25-14-377490,3561262,5135,
3561274,3566381,2022-10-24_16-25-19-702027,3566389,5107,
3566404,3571499,2022-10-24_16-25-24-908699,3571509,5095,
3571521,3576646,2022-10-24_16-25-30-043527,3576661,5125,
3576673,3581753,2022-10-24_16-25-35-369512,3581764,5080,
3581778,3586899,2022-10-24_16-25-40-659442,3586908,5121,
3586920,3586991,2022-10-24_16-25-45-815130,3586993,71,
3592052,3592084,2022-10-24_16-25-51-036694,3592087,32,
3597179,3597289,2022-10-24_16-25-56-361370,3602325,110,
3602347,3602388,2022-10-24_16-26-01-583980,3602391,41,
3607464,3607488,2022-10-24_16-26-06-811183,3607492,24,
3612587,3617708,2022-10-24_16-26-12-132676,3617717,5121,
3617728,3617754,2022-10-24_16-26-17-319229,3617757,26,
3622847,3622889,2022-10-24_16-26-22-576442,3622892,42,
3627967,3627997,2022-10-24_16-26-27-798641,3628000,30,
3633082,3633102,2022-10-24_16-26-33-025216,3633105,20,
3638194,3638216,2022-10-24_16-26-38-255801,3638218,22,
3643320,3648435,2022-10-24_16-26-43-569683,3648451,5115,
3648472,3653543,2022-10-24_16-26-49-098122,3653558,5071,
3653579,3653619,2022-10-24_16-26-54-017807,3653622,40,
3658648,3658669,2022-10-24_16-26-59-186792,3658672,21,
3663769,3668902,2022-10-24_16-27-04-590029,3668917,5133,
3668928,3668951,2022-10-24_16-27-09-707021,3668954,23,
3674041,3679153,2022-10-24_16-27-15-006277,3679168,5112,
3679189,3684253,2022-10-24_16-27-20-274092,3684262,5064,
3684274,3689361,2022-10-24_16-27-25-450172,3689371,5087,
3689383,3694479,2022-10-24_16-27-30-777117,3694488,5096,
3694501,3694551,2022-10-24_16-27-35-895872,3694554,50,
3699630,3704744,2022-10-24_16-27-41-220924,3704754,5114,
3704773,3709852,2022-10-24_16-27-46-616448,3709865,5079,
3709887,3709958,2022-10-24_16-27-51-666364,3709960,71,
3714973,3720081,2022-10-24_16-27-56-958802,3720091,5108,
3720103,3725230,2022-10-24_16-28-02-213399,3725242,5127,
3725253,3725276,2022-10-24_16-28-07-348941,3725279,23,
3730342,3735473,2022-10-24_16-28-12-658330,3735482,5131,
3735501,3735568,2022-10-24_16-28-17-880804,3735571,67,
3740620,3740668,2022-10-24_16-28-23-102849,3740671,48,
3745756,3745776,2022-10-24_16-28-28-328861,3745779,20,
3750866,3750893,2022-10-24_16-28-33-565387,3750895,27,
3755980,3756000,2022-10-24_16-28-38-791820,3756002,20,
3761090,3761109,2022-10-24_16-28-44-021693,3761112,19,
3766230,3771361,2022-10-24_16-28-49-420629,3771372,5131,
3771384,3776475,2022-10-24_16-28-54-642680,3776484,5091,
3776501,3776595,2022-10-24_16-28-59-865706,3776598,94,
3781629,3781648,2022-10-24_16-29-05-035283,3781651,19,
3786747,3791862,2022-10-24_16-29-10-412098,3791878,5115,
3791892,3792013,2022-10-24_16-29-15-615551,3796958,121,
3796976,3797012,2022-10-24_16-29-20-755370,3797015,36,
3802084,3802111,2022-10-24_16-29-25-977562,3802114,27,
3807223,3807316,2022-10-24_16-29-31-302560,3807318,93,
3812332,3812421,2022-10-24_16-29-36-524878,3812423,89,
3817443,3817520,2022-10-24_16-29-41-747361,3817522,77,
3822593,3822625,2022-10-24_16-29-46-971603,3822629,32,
3827702,3832819,2022-10-24_16-29-52-295461,3832829,5117,
3832843,3832926,2022-10-24_16-29-57-513062,3832928,83,
3837954,3843092,2022-10-24_16-30-02-780473,3843105,5138,
3843118,3843139,2022-10-24_16-30-07-970528,3843142,21,
3848203,3848230,2022-10-24_16-30-13-185898,3848233,27,
3853313,3853340,2022-10-24_16-30-18-408044,3853343,27,
3858425,3858445,2022-10-24_16-30-23-637721,3858448,20,
3863533,3868644,2022-10-24_16-30-29-029754,3868653,5111,
3868668,3868744,2022-10-24_16-30-34-178117,3868747,76,
3873773,3878879,2022-10-24_16-30-39-400610,3878892,5106,
3878912,3883995,2022-10-24_16-30-44-724683,3884010,5083,
3884027,3884069,2022-10-24_16-30-49-851212,3884075,42,
3889108,3894238,2022-10-24_16-30-55-170346,3894247,5130,
3894259,3894280,2022-10-24_16-31-00-313955,3894284,21,
3899388,3904510,2022-10-24_16-31-05-615000,3904520,5122,
3904532,3909648,2022-10-24_16-31-10-938545,3909663,5116,
3909675,3909696,2022-10-24_16-31-16-087642,3909699,21,
3914759,3919871,2022-10-24_16-31-21-384033,3919887,5112,
3919908,3924969,2022-10-24_16-31-26-709456,3924982,5061,
3925002,3925075,2022-10-24_16-31-31-829086,3925078,73,
3930109,3935225,2022-10-24_16-31-37-154948,3935234,5116,
3935247,3940371,2022-10-24_16-31-42-376300,3940380,5124,
3940402,3940481,2022-10-24_16-31-47-599032,3940484,79,
3945499,3950604,2022-10-24_16-31-52-820714,3950614,5105,
3950629,3955712,2022-10-24_16-31-58-121694,3955721,5083,
3955734,3955784,2022-10-24_16-32-03-266704,3955787,50,
3960829,3960858,2022-10-24_16-32-08-452644,3960861,29,
3965973,3965994,2022-10-24_16-32-13-711828,3965997,21,
3971077,3976198,2022-10-24_16-32-19-240546,3976207,5121,
3976224,3976299,2022-10-24_16-32-24-259460,3976303,75,
3981323,0,,3986430,-3981323,
3986445,3991543,2022-10-24_16-32-34-805696,3991559,5098,
3991581,3996652,2022-10-24_16-32-40-019087,3996667,5071,
3996689,4001761,2022-10-24_16-32-45-250427,4001776,5072,
4001782,4006867,2022-10-24_16-32-50-473574,4006882,5085,
4006902,4006927,2022-10-24_16-32-55-595129,4006930,25,
4011981,4012026,2022-10-24_16-33-00-816816,4012029,45,
4017121,4022249,2022-10-24_16-33-06-141913,4022258,5128,
4022270,4027364,2022-10-24_16-33-11-467160,4027380,5094,
4027401,4027438,2022-10-24_16-33-16-585993,4027442,37,
4032468,4032489,2022-10-24_16-33-21-754217,4032492,21,
4037579,4037599,2022-10-24_16-33-26-986816,4037602,20,
4042725,4047846,2022-10-24_16-33-32-355751,4047855,5121,
4047874,4047963,2022-10-24_16-33-37-583793,4047966,89,
4053001,4058102,2022-10-24_16-33-42-903812,4058117,5101,
4058139,4058166,2022-10-24_16-33-48-021970,4058170,27,
4063235,4063281,2022-10-24_16-33-53-267614,4063284,46,
4068364,0,,4068455,-4068364,
4073463,4073491,2022-10-24_16-34-03-720156,4073494,28,
4078630,4078684,2022-10-24_16-34-09-034077,4078687,54,
4083748,4083769,2022-10-24_16-34-14-242881,4083772,21,
4088885,4093999,2022-10-24_16-34-19-768941,4094009,5114,
4094027,4099108,2022-10-24_16-34-24-887222,4099117,5081,
4099129,4099176,2022-10-24_16-34-30-007412,4099178,47,
4104264,4109384,2022-10-24_16-34-35-332841,4109393,5120,
4109410,4109487,2022-10-24_16-34-40-555786,4109490,77,
4114530,4119660,2022-10-24_16-34-45-880144,4119672,5130,
4119683,4119721,2022-10-24_16-34-51-031301,4119723,38,
4124755,4124800,2022-10-24_16-34-56-222945,4124803,45,
4129875,4129896,2022-10-24_16-35-01-440946,4129899,21,
4135008,4140124,2022-10-24_16-35-06-770229,4140139,5116,
4140160,4140210,2022-10-24_16-35-11-992326,4140213,50,
4145229,4150332,2022-10-24_16-35-17-215326,4150344,5103,
4150366,4155446,2022-10-24_16-35-22-539248,4155460,5080,
4155482,4155521,2022-10-24_16-35-27-661072,4155524,39,
4160561,4160617,2022-10-24_16-35-32-881759,4160620,56,
4165669,4170794,2022-10-24_16-35-38-207460,4170805,5125,
4170818,4170867,2022-10-24_16-35-43-367824,4170870,49,
4175945,4176025,2022-10-24_16-35-48-652644,4176028,80,
4181063,4186182,2022-10-24_16-35-53-977074,4186197,5119,
4186217,4186337,2022-10-24_16-35-59-143614,4191291,120,
4191313,4191356,2022-10-24_16-36-04-331125,4191359,43,
4196404,4201539,2022-10-24_16-36-09-643937,4201547,5135,
4201569,4201649,2022-10-24_16-36-14-867513,4201652,80,
4206665,4206684,2022-10-24_16-36-20-021855,4206687,19,
4211778,4216878,2022-10-24_16-36-25-312183,4216893,5100,
4216905,4216930,2022-10-24_16-36-30-499859,4216933,25,
4221989,4227108,2022-10-24_16-36-35-757381,4227125,5119,
4227145,4232216,2022-10-24_16-36-41-081934,4232232,5071,
4232248,4237337,2022-10-24_16-36-46-304910,4237352,5089,
4237364,4237383,2022-10-24_16-36-51-435456,4237387,19,
4242450,4247582,2022-10-24_16-36-56-752966,4247591,5132,
4247610,4252716,2022-10-24_16-37-02-073728,4252726,5106,
4252738,4252781,2022-10-24_16-37-07-195320,4252785,43,
4257836,4257880,2022-10-24_16-37-12-417528,4257883,44,
4262938,4262985,2022-10-24_16-37-17-639917,4262987,47,
4268051,4273169,2022-10-24_16-37-22-964228,4273183,5118,
4273196,4273225,2022-10-24_16-37-28-121767,4273228,29,
4278306,4278327,2022-10-24_16-37-33-339282,4278330,21,
4283421,4283490,2022-10-24_16-37-38-623432,4283494,69,
4288522,4288606,2022-10-24_16-37-43-827775,4288609,84,
4293629,4298751,2022-10-24_16-37-49-281166,4298760,5122,
4298772,4298813,2022-10-24_16-37-54-299916,4298816,41,
4303863,4303884,2022-10-24_16-37-59-488018,4303887,21,
4308981,4314082,2022-10-24_16-38-04-849088,4314096,5101,
4314114,4314216,2022-10-24_16-38-10-069838,4314219,102,
4319230,0,,4319269,-4319230,
4324358,4329489,2022-10-24_16-38-20-513316,4329498,5131,
4329510,4329530,2022-10-24_16-38-25-752436,4329533,20,
4334606,4339727,2022-10-24_16-38-31-063704,4339737,5121,
4339755,4339827,2022-10-24_16-38-36-287243,4339830,72,
4344899,4344924,2022-10-24_16-38-41-507975,4344927,25,
4350009,4355141,2022-10-24_16-38-46-830489,4355150,5132,
4355169,4360282,2022-10-24_16-38-52-053044,4360297,5113,
4360314,4365384,2022-10-24_16-38-57-381171,4365398,5070,
4365417,4365439,2022-10-24_16-39-02-495178,4365441,22,
4370494,4370544,2022-10-24_16-39-07-720440,4370548,50,
4375611,0,,4375660,-4375611,
4380716,4380741,2022-10-24_16-39-18-167782,4380744,25,
4385848,4390962,2022-10-24_16-39-23-485855,4390977,5114,
4390999,4391064,2022-10-24_16-39-28-728597,4391067,65,
4396085,4396147,2022-10-24_16-39-33-937358,4396149,62,
4401194,4406322,2022-10-24_16-39-39-260806,4406333,5128,
4406345,4411560,2022-10-24_16-39-44-484638,4411575,5215,
4411596,4416668,2022-10-24_16-39-49-879979,4416678,5072,
4416690,4421804,2022-10-24_16-39-55-030412,4421820,5114,
4421842,4426912,2022-10-24_16-40-00-357864,4426927,5070,
4426949,4432021,2022-10-24_16-40-05-604770,4432037,5072,
4432053,0,,4437122,-4432053,
4437134,4437174,2022-10-24_16-40-15-920759,4437177,40,
4442267,4442293,2022-10-24_16-40-21-149918,4442295,26,
4447385,4447484,2022-10-24_16-40-26-467118,4447487,99,
4452487,4452505,2022-10-24_16-40-31-613046,4452508,18,
4457612,4462720,2022-10-24_16-40-37-016435,4462730,5108,
4462746,4462792,2022-10-24_16-40-42-131444,4462795,46,
4467839,4467888,2022-10-24_16-40-47-358941,4467891,49,
4472973,4472996,2022-10-24_16-40-52-585851,4472999,23,
4478094,4483205,2022-10-24_16-40-57-906403,4483214,5111,
4483217,4483307,2022-10-24_16-41-03-128956,4483310,90,
4488337,4493458,2022-10-24_16-41-08-453639,4493471,5121,
4493484,4498600,2022-10-24_16-41-13-677142,4498609,5116,
4498624,4498712,2022-10-24_16-41-18-893286,4498715,88,
4503743,4503810,2022-10-24_16-41-24-123852,4503813,67,
4508883,4514029,2022-10-24_16-41-29-445002,4514044,5146,
4514065,4519135,2022-10-24_16-41-34-770854,4519151,5070,
4519173,4524236,2022-10-24_16-41-39-993072,4524250,5063,
4524272,4524321,2022-10-24_16-41-45-113346,4524324,49,
4529357,4534480,2022-10-24_16-41-50-416752,4534496,5123,
4534517,4534538,2022-10-24_16-41-55-566662,4534541,21,
4539589,4539629,2022-10-24_16-42-00-782263,4539632,40,
4544745,4549848,2022-10-24_16-42-06-212302,4549857,5103,
4549871,4549915,2022-10-24_16-42-11-317473,4549918,44,
4554965,4555026,2022-10-24_16-42-16-552525,4555029,61,
4560106,4565234,2022-10-24_16-42-21-874902,4565242,5128,
4565262,4565333,2022-10-24_16-42-27-096280,4565335,71,
4570379,4570435,2022-10-24_16-42-32-320155,4570438,56,
4575516,4575554,2022-10-24_16-42-37-557473,4575557,38,
4580639,4580659,2022-10-24_16-42-42-779828,4580662,20,
4585751,4585773,2022-10-24_16-42-48-011371,4585776,22,
4590863,4595969,2022-10-24_16-42-53-312269,4595979,5106,
4595993,4601079,2022-10-24_16-42-58-637106,4601095,5086,
4601116,4606191,2022-10-24_16-43-03-964845,4606207,5075,
4606228,4606259,2022-10-24_16-43-08-980118,4606262,31,
4611306,4611356,2022-10-24_16-43-14-201957,4611359,50,
4616404,4616424,2022-10-24_16-43-19-384113,4616427,20,
4621554,4626655,2022-10-24_16-43-24-852934,4626671,5101,
4626682,4631789,2022-10-24_16-43-29-970984,4631797,5107,
4631817,4631872,2022-10-24_16-43-35-195133,4631875,55,
4636908,4642035,2022-10-24_16-43-40-520598,4642051,5127,
4642066,4647136,2022-10-24_16-43-45-741816,4647149,5070,
4647154,4652282,2022-10-24_16-43-50-965276,4652290,5128,
4652308,4657390,2022-10-24_16-43-56-260290,4657399,5082,
4657412,4662523,2022-10-24_16-44-01-409329,4662539,5111,
4662560,4667629,2022-10-24_16-44-06-734919,4667639,5069,
4667651,4667672,2022-10-24_16-44-11-840934,4667674,21,
4672748,4672792,2022-10-24_16-44-17-077069,4672795,44,
4677857,4677886,2022-10-24_16-44-22-291428,4677889,29,
4682955,4688084,2022-10-24_16-44-27-623799,4688099,5129,
4688112,4688131,2022-10-24_16-44-32-773843,4688134,19,
4693194,4698301,2022-10-24_16-44-38-068065,4698310,5107,
4698323,4703420,2022-10-24_16-44-43-347435,4703430,5097,
4703448,4708570,2022-10-24_16-44-48-615384,4708586,5122,
4708601,4708625,2022-10-24_16-44-53-740293,4708628,24,
4713684,4718794,2022-10-24_16-44-59-061595,4718808,5110,
4718820,4718864,2022-10-24_16-45-04-215051,4718867,44,
4723904,4729005,2022-10-24_16-45-09-505899,4729021,5101,
4729033,4729054,2022-10-24_16-45-14-652727,4729057,21,
4734117,4739228,2022-10-24_16-45-19-951688,4739242,5111,
4739255,4739275,2022-10-24_16-45-25-122457,4739278,20,
4744339,4749449,2022-10-24_16-45-30-396255,4749465,5110,
4749487,4749517,2022-10-24_16-45-35-609846,4749520,30,
4754564,4754643,2022-10-24_16-45-40-839803,4754647,79,
4759672,4764774,2022-10-24_16-45-46-086973,4764790,5102,
4764810,4764842,2022-10-24_16-45-51-289962,4764845,32,
4769887,4769942,2022-10-24_16-45-56-509751,4769945,55,
4774996,4780115,2022-10-24_16-46-01-759207,4780127,5119,
4780139,4780160,2022-10-24_16-46-06-966078,4780163,21,
4785227,4790344,2022-10-24_16-46-12-280187,4790358,5117,
4790379,4790452,2022-10-24_16-46-17-495884,4790455,73,
4795484,4800592,2022-10-24_16-46-22-757458,4800600,5108,
4800612,4800651,2022-10-24_16-46-27-945023,4800654,39,
4805738,4810845,2022-10-24_16-46-33-270381,4810860,5107,
4810880,4810965,2022-10-24_16-46-38-491977,4810971,85,
4815958,4816063,2022-10-24_16-46-43-715841,4821064,105,
4821078,4821187,2022-10-24_16-46-48-958449,4826193,109,
4826215,4831300,2022-10-24_16-46-54-263829,4831316,5085,
4831338,4831374,2022-10-24_16-46-59-383688,4831380,36,
4836406,4836467,2022-10-24_16-47-04-604738,4836470,61,
4841534,4846679,2022-10-24_16-47-09-930235,4846687,5145,
4846700,4846773,2022-10-24_16-47-15-154786,4846776,73,
4851823,4856946,2022-10-24_16-47-20-478169,4856951,5123,
4856952,4862093,2022-10-24_16-47-25-702039,4862102,5141,
4862114,4867237,2022-10-24_16-47-30-925052,4867251,5123,
4867263,4867284,2022-10-24_16-47-36-158988,4867287,21,
4872350,4872395,2022-10-24_16-47-41-375566,4872400,45,
4877484,4877504,2022-10-24_16-47-46-610940,4877508,20,
4882624,4882696,2022-10-24_16-47-51-918245,4882699,72,
4887756,4892886,2022-10-24_16-47-57-241217,4892901,5130,
4892913,4892933,2022-10-24_16-48-02-398004,4892937,20,
4898026,4903135,2022-10-24_16-48-07-686862,4903143,5109,
4903161,4903208,2022-10-24_16-48-12-908924,4903211,47,
4908286,4908308,2022-10-24_16-48-18-132702,4908310,22,
4913437,4918566,2022-10-24_16-48-23-560992,4918582,5129,
4918596,4923674,2022-10-24_16-48-28-780036,4923686,5078,
4923703,4923817,2022-10-24_16-48-33-997782,4928782,114,
4928801,4933920,2022-10-24_16-48-39-329316,4933928,5119,
4933946,4939058,2022-10-24_16-48-44-548884,4939073,5112,
4939095,4944165,2022-10-24_16-48-49-876971,4944181,5070,
4944202,4949273,2022-10-24_16-48-54-998177,4949289,5071,
4949311,4954380,2022-10-24_16-49-00-217543,4954396,5069,
4954414,4959486,2022-10-24_16-49-05-541198,4959502,5072,
4959524,4964597,2022-10-24_16-49-10-765059,4964610,5073,
4964629,4969705,2022-10-24_16-49-16-028372,4969715,5076,
4969735,4974820,2022-10-24_16-49-21-209759,4974829,5085,
4974842,4979952,2022-10-24_16-49-26-328475,4979967,5110,
4979989,4985052,2022-10-24_16-49-31-635702,4985065,5063,
4985087,4990166,2022-10-24_16-49-36-811774,4990175,5079,
4990188,4990246,2022-10-24_16-49-42-000370,4990251,58,
4995272,4995355,2022-10-24_16-49-47-222120,4995358,83,
5000394,5005522,2022-10-24_16-49-52-545086,5005538,5128,
5005550,5010623,2022-10-24_16-49-57-766657,5010637,5073,
5010661,5015771,2022-10-24_16-50-03-091900,5015780,5110,
5015799,5015872,2022-10-24_16-50-08-213971,5015875,73,
5020926,5020977,2022-10-24_16-50-13-436974,5020982,51,
5026052,5031162,2022-10-24_16-50-18-759001,5031171,5110,
5031184,5031205,2022-10-24_16-50-23-916233,5031208,21,
5036273,5041401,2022-10-24_16-50-29-203976,5041417,5128,
5041438,5046543,2022-10-24_16-50-34-530681,5046554,5105,
5046567,5046588,2022-10-24_16-50-39-665696,5046591,21,
5051655,5051690,2022-10-24_16-50-44-878956,5051692,35,
5056757,5056787,2022-10-24_16-50-50-103452,5056790,30,
5061903,5067024,2022-10-24_16-50-55-522693,5067038,5121,
5067059,5067093,2022-10-24_16-51-00-641218,5067095,34,
5072128,5077261,2022-10-24_16-51-05-965705,5077270,5133,
5077283,5077302,2022-10-24_16-51-11-102821,5077306,19,
5082410,5082431,2022-10-24_16-51-16-345832,5082433,21,
5087559,5092685,2022-10-24_16-51-21-736249,5092694,5126,
5092706,5097811,2022-10-24_16-51-26-958763,5097820,5105,
5097834,5102958,2022-10-24_16-51-32-282890,5102974,5124,
5102988,5103103,2022-10-24_16-51-37-453064,5108058,115,
5108071,5108106,2022-10-24_16-51-42-625967,5108109,35,
5113179,5113207,2022-10-24_16-51-47-848360,5113210,28,
5118296,5123420,2022-10-24_16-51-53-175382,5123430,5124,
5123442,5128565,2022-10-24_16-51-58-394905,5128575,5123,
5128586,5133722,2022-10-24_16-52-03-721139,5133730,5136,
5133742,5133763,2022-10-24_16-52-08-893134,5133767,21,
5138833,5143947,2022-10-24_16-52-14-267915,5143964,5114,
5143985,5149152,2022-10-24_16-52-19-425329,5149168,5167,
5149173,5154259,2022-10-24_16-52-24-815220,5154275,5086,
5154296,5159369,2022-10-24_16-52-30-037124,5159386,5073,
5159407,5164477,2022-10-24_16-52-35-261218,5164492,5070,
5164509,5169584,2022-10-24_16-52-40-593033,5169600,5075,
5169619,5174693,2022-10-24_16-52-45-806980,5174709,5074,
5174728,5174832,2022-10-24_16-52-50-927180,5179794,104,
5179807,5184940,2022-10-24_16-52-56-251942,5184948,5133,
5184968,5190046,2022-10-24_16-53-01-474485,5190055,5078,
5190067,5195155,2022-10-24_16-53-06-696964,5195164,5088,
5195176,5195233,2022-10-24_16-53-11-800506,5195236,57,
5200269,5205389,2022-10-24_16-53-17-043059,5205404,5120,
5205426,5210489,2022-10-24_16-53-22-364864,5210498,5063,
5210512,5210564,2022-10-24_16-53-27-486124,5210567,52,
5215610,5220741,2022-10-24_16-53-32-812054,5220755,5131,
5220768,5220796,2022-10-24_16-53-37-960001,5220799,28,
5225862,5230966,2022-10-24_16-53-43-255472,5230980,5104,
5230985,5231070,2022-10-24_16-53-48-477534,5231073,85,
5236167,5236187,2022-10-24_16-53-53-718794,5236190,20,
5241292,5246406,2022-10-24_16-53-59-025308,5246414,5114,
5246433,5251520,2022-10-24_16-54-04-349141,5251536,5087,
5251557,5256642,2022-10-24_16-54-09-565709,5256653,5085,
5256665,5261773,2022-10-24_16-54-14-794777,5261782,5108,
5261796,5261883,2022-10-24_16-54-20-019286,5261886,87,
5266913,5267026,2022-10-24_16-54-25-284880,5272045,113,
5272062,5277182,2022-10-24_16-54-30-566833,5277191,5120,
5277203,5282338,2022-10-24_16-54-35-787042,5282354,5135,
5282372,5282494,2022-10-24_16-54-41-074806,5287452,122,
5287465,5292571,2022-10-24_16-54-46-444038,5292579,5106,
5292592,5292629,2022-10-24_16-54-51-485473,5292631,37,
5297715,5297804,2022-10-24_16-54-56-780200,5297807,89,
5302825,5307939,2022-10-24_16-55-02-001633,5307954,5114,
5307976,5313047,2022-10-24_16-55-07-329213,5313062,5071,
5313084,5313114,2022-10-24_16-55-12-446823,5313117,30,
5318161,5323288,2022-10-24_16-55-17-771435,5323299,5127,
5323311,5328397,2022-10-24_16-55-22-994430,5328406,5086,
5328418,5328468,2022-10-24_16-55-28-165702,5328471,50,
5333549,5338665,2022-10-24_16-55-33-440732,5338680,5116,
5338697,5338722,2022-10-24_16-55-38-671414,5338725,25,
5343824,5343845,2022-10-24_16-55-43-913386,5343848,21,
5348930,5354040,2022-10-24_16-55-49-285313,5354050,5110,
5354069,5354120,2022-10-24_16-55-54-431791,5354123,51,
5359194,5364296,2022-10-24_16-55-59-960490,5364301,5102,
5364301,5369425,2022-10-24_16-56-04-978606,5369435,5124,
5369447,5369541,2022-10-24_16-56-10-183254,5369544,94,
5374568,5379696,2022-10-24_16-56-15-424520,5379712,5128,
5379726,5379751,2022-10-24_16-56-20-648361,5379754,25,
5384807,5389943,2022-10-24_16-56-25-971032,5389952,5136,
5389965,5389986,2022-10-24_16-56-31-126438,5389989,21,
5395102,5400202,2022-10-24_16-56-36-521926,5400212,5100,
5400224,5400262,2022-10-24_16-56-41-638790,5400264,38,
5405345,5410467,2022-10-24_16-56-46-963696,5410475,5122,
5410488,5410552,2022-10-24_16-56-52-185906,5410554,64,
5415608,5420728,2022-10-24_16-56-57-614500,5420737,5120,
5420752,5425843,2022-10-24_16-57-02-836495,5425852,5091,
5425865,5430947,2022-10-24_16-57-07-947930,5430956,5082,
5430968,5436052,2022-10-24_16-57-13-177866,5436061,5084,
5436073,5436099,2022-10-24_16-57-18-321778,5436102,26,
5441196,5446339,2022-10-24_16-57-23-828090,5446354,5143,
5446373,5446398,2022-10-24_16-57-28-863926,5446401,25,
5451452,5451496,2022-10-24_16-57-34-082948,5451499,44,
5456560,5461677,2022-10-24_16-57-39-395093,5461685,5117,
5461707,5461789,2022-10-24_16-57-44-616383,5461791,82,
5466801,5471905,2022-10-24_16-57-49-838018,5471914,5104,
5471926,5471985,2022-10-24_16-57-55-042726,5471988,59,
5477017,5482142,2022-10-24_16-58-00-384643,5482158,5125,
5482179,5482261,2022-10-24_16-58-05-559313,5482263,82,
5487298,5487329,2022-10-24_16-58-10-751800,5487331,31,
5492405,5492502,2022-10-24_16-58-16-052188,5492505,97,
5497528,5497610,2022-10-24_16-58-21-275426,5497613,82,
5502636,5507731,2022-10-24_16-58-26-600116,5507739,5095,
5507755,5512869,2022-10-24_16-58-32-027297,5512884,5114,
5512900,5512924,2022-10-24_16-58-36-948875,5512927,24,
5517984,5523109,2022-10-24_16-58-42-267576,5523118,5125,
5523137,5528253,2022-10-24_16-58-47-576916,5528268,5116,
5528289,5528338,2022-10-24_16-58-52-721061,5528341,49,
5533365,5538462,2022-10-24_16-58-58-043395,5538471,5097,
5538489,5538538,2022-10-24_16-59-03-154816,5538541,49,
5543582,5543634,2022-10-24_16-59-08-380019,5543637,52,
5548688,5553817,2022-10-24_16-59-13-682970,5553827,5129,
5553839,5553861,2022-10-24_16-59-18-850485,5553864,22,
5558925,5558945,2022-10-24_16-59-24-060112,5558948,20,
5564065,5564084,2022-10-24_16-59-29-321249,5564087,19,
5569181,5569241,2022-10-24_16-59-34-599895,5569243,60,
5574318,5579445,2022-10-24_16-59-40-028330,5579455,5127,
5579467,5579491,2022-10-24_16-59-45-088253,5579494,24,
5584556,5589668,2022-10-24_16-59-50-364554,5589684,5112,
5589705,5594769,2022-10-24_16-59-55-688775,5594778,5064,
5594790,5599907,2022-10-24_17-00-00-912116,5599916,5117,
5599928,5605044,2022-10-24_17-00-06-134114,5605053,5116,
5605065,5605091,2022-10-24_17-00-11-277500,5605094,26,
5610154,5610269,2022-10-24_17-00-16-585082,5615283,115,
5615304,5615418,2022-10-24_17-00-21-854357,5620384,114,
5620402,5620471,2022-10-24_17-00-27-029218,5620474,69,
5625496,5625516,2022-10-24_17-00-32-196902,5625519,20,
5630606,5630684,2022-10-24_17-00-37-468044,5630687,78,
5635722,5635766,2022-10-24_17-00-42-682176,5635769,44,
5640830,5640877,2022-10-24_17-00-47-913631,5640879,47,
5645960,5646008,2022-10-24_17-00-53-166612,5646013,48,
5651111,5651202,2022-10-24_17-00-58-470150,5651208,91,
5656210,5656292,2022-10-24_17-01-03-680863,5656294,82,
5661332,5661401,2022-10-24_17-01-08-914677,5661404,69,
5666471,5666496,2022-10-24_17-01-14-135429,5666499,25,
5671591,5671635,2022-10-24_17-01-19-394208,5671638,44,
5676716,5676814,2022-10-24_17-01-24-681427,5676819,98,
5681824,5681854,2022-10-24_17-01-29-855700,5681857,30,
5686942,5686995,2022-10-24_17-01-35-115886,5686998,53,
5692040,5692062,2022-10-24_17-01-40-299215,5692065,22,
5697152,5697171,2022-10-24_17-01-45-528869,5697174,19,
5702281,5702350,2022-10-24_17-01-50-814199,5702354,69,
5707412,5707433,2022-10-24_17-01-56-029237,5707436,21,
5712540,5712636,2022-10-24_17-02-01-342955,5712642,96,
5717667,5717716,2022-10-24_17-02-06-550845,5717719,49,
5722801,5722872,2022-10-24_17-02-11-828983,5722875,71,
5727947,5728044,2022-10-24_17-02-17-125752,5728046,97,
5733069,5733148,2022-10-24_17-02-22-338498,5733154,79,
5738198,5738248,2022-10-24_17-02-27-563861,5738250,50,
5743347,5743371,2022-10-24_17-02-32-812903,5743374,24,
5748476,5748496,2022-10-24_17-02-38-057978,5748498,20,
5753615,5753658,2022-10-24_17-02-43-340413,5753660,43,
5758767,5758867,2022-10-24_17-02-48-655891,5758874,100,
5763892,5763955,2022-10-24_17-02-53-876613,5763960,63,
5769036,5769057,2022-10-24_17-02-59-099192,5769062,21,
5774176,5774276,2022-10-24_17-03-04-436968,5774279,100,
5779287,5779311,2022-10-24_17-03-09-596117,5779314,24,
5784426,5784481,2022-10-24_17-03-14-868650,5784487,55,
5789557,5789651,2022-10-24_17-03-20-176071,5789654,94,
5794667,5794687,2022-10-24_17-03-25-332937,5794690,20,
5799790,5799809,2022-10-24_17-03-30-573941,5799812,19,
5804912,5804972,2022-10-24_17-03-35-861018,5804976,60,
5810046,5810073,2022-10-24_17-03-41-079613,5810078,27,
5815170,5815190,2022-10-24_17-03-46-317962,5815193,20,
5820268,5820288,2022-10-24_17-03-51-543387,5820291,20,
5825412,5825467,2022-10-24_17-03-56-835387,5825470,55,
5830543,5830606,2022-10-24_17-04-02-078423,5830608,63,
5835670,5835704,2022-10-24_17-04-07-299900,5835708,34,
5840816,5840903,2022-10-24_17-04-12-625030,5840908,87,
5845946,5845994,2022-10-24_17-04-17-842921,5845999,48,
5851053,5851078,2022-10-24_17-04-23-049429,5851081,25,
5856159,5856210,2022-10-24_17-04-28-303979,5856214,51,
5861284,5861312,2022-10-24_17-04-33-531979,5861314,28,
5866405,5866484,2022-10-24_17-04-38-818559,5866487,79,
5871527,5871615,2022-10-24_17-04-44-057453,5871620,88,
5876644,5876718,2022-10-24_17-04-49-293788,5876721,74,
5881743,5881774,2022-10-24_17-04-54-469628,5881777,31,
5886878,5886907,2022-10-24_17-04-59-718424,5886909,29,
5891991,5892110,2022-10-24_17-05-05-047992,5897124,119,
5897136,5897156,2022-10-24_17-05-10-211470,5897159,20,
5902281,5902304,2022-10-24_17-05-15-484626,5902307,23,
5907390,5907472,2022-10-24_17-05-20-771770,5907474,82,
5912495,5912520,2022-10-24_17-05-25-937806,5912523,25,
5917600,5917622,2022-10-24_17-05-31-164026,5917624,22,
5922740,5922832,2022-10-24_17-05-36-476153,5922835,92,
5927839,5927859,2022-10-24_17-05-41-634937,5927863,20,
5932975,5933044,2022-10-24_17-05-46-932382,5933048,69,
5938083,5938142,2022-10-24_17-05-52-152856,5938145,59,
5943192,5943244,2022-10-24_17-05-57-384931,5943247,52,
5948300,5948362,2022-10-24_17-06-02-606719,5948367,62,
5953399,5953419,2022-10-24_17-06-07-794415,5953422,20,
5958535,5958628,2022-10-24_17-06-13-131786,5958630,93,
5963643,5963663,2022-10-24_17-06-18-277184,5963667,20,
5968795,5968832,2022-10-24_17-06-23-568619,5968835,37,
5973902,5973924,2022-10-24_17-06-28-781268,5973927,22,
5979049,5979069,2022-10-24_17-06-34-047417,5979072,20,
5984156,5984171,2022-10-24_17-06-39-277482,5984181,15,
5989277,5989298,2022-10-24_17-06-44-515350,5989301,21,
5994386,5994481,2022-10-24_17-06-49-809712,5994486,95,
5999503,5999567,2022-10-24_17-06-55-029024,5999571,64,
6004612,6004682,2022-10-24_17-07-00-254373,6004688,70,
6009719,6009787,2022-10-24_17-07-05-477463,6009790,68,
6014828,6014881,2022-10-24_17-07-10-694559,6014886,53,
6019926,6019946,2022-10-24_17-07-15-887375,6019950,20,
6025045,0,,6025093,-6025045,
6030151,6030177,2022-10-24_17-07-26-351923,6030180,26,
6035280,6035300,2022-10-24_17-07-31-603666,6035302,20,
6040405,6040481,2022-10-24_17-07-36-898906,6040483,76,
6045528,6045596,2022-10-24_17-07-42-136433,6045600,68,
6050638,0,,6055747,-6050638,
6055759,6055785,2022-10-24_17-07-52-565109,6055788,26,
6060867,6060903,2022-10-24_17-07-57-799667,6060906,36,
6065975,6066013,2022-10-24_17-08-03-025793,6066019,38,
6071087,6071107,2022-10-24_17-08-08-249826,6071110,20,
6076246,6076266,2022-10-24_17-08-13-522031,6076270,20,
6081357,6081378,2022-10-24_17-08-18-753668,6081381,21,
6086502,6086523,2022-10-24_17-08-24-019230,6086526,21,
6091616,6091636,2022-10-24_17-08-29-251775,6091639,20,
6096745,6096835,2022-10-24_17-08-34-564042,6096840,90,