RD,TS_received,TS_sent,AK,RoundTrip,
241253,241275,2022-12-25_17-25-03-842031,241277,22,
246388,251501,2022-12-25_17-25-09-179357,251510,5113,
251522,251543,2022-12-25_17-25-14-352864,251546,21,
256610,256640,2022-12-25_17-25-19-561832,256643,30,
261739,261830,2022-12-25_17-25-24-873315,261832,91,
266856,266929,2022-12-25_17-25-30-088822,266932,73,
271982,277104,2022-12-25_17-25-35-329959,277112,5122,
277125,282253,2022-12-25_17-25-40-656637,282262,5128,
282274,287393,2022-12-25_17-25-45-878475,287409,5119,
287430,287475,2022-12-25_17-25-51-104840,287480,45,
292497,297624,2022-12-25_17-25-56-325149,297640,5127,
297664,297777,2022-12-25_17-26-01-647952,302732,113,
302753,307840,2022-12-25_17-26-06-867286,307856,5087,
307870,312993,2022-12-25_17-26-12-093997,313002,5123,
313014,313102,2022-12-25_17-26-17-315006,313105,88,
318134,318155,2022-12-25_17-26-22-483070,318158,21,
323240,323260,2022-12-25_17-26-27-707064,323263,20,
328365,328385,2022-12-25_17-26-32-950579,328388,20,
333498,333520,2022-12-25_17-26-38-205193,333523,22,
338626,338646,2022-12-25_17-26-43-457858,338650,20,
343734,343813,2022-12-25_17-26-48-728675,343815,79,
348865,353966,2022-12-25_17-26-54-080097,353981,5101,
354002,354108,2022-12-25_17-26-59-300194,359074,106,
359092,364213,2022-12-25_17-27-04-624502,364221,5121,
364238,364320,2022-12-25_17-27-09-746752,364325,82,
369373,369430,2022-12-25_17-27-14-972841,369435,57,
374509,374529,2022-12-25_17-27-20-196995,374532,20,
379667,384805,2022-12-25_17-27-25-617157,384817,5138,
384830,384854,2022-12-25_17-27-30-751600,384857,24,
389911,389935,2022-12-25_17-27-35-960083,389938,24,
395021,395041,2022-12-25_17-27-41-187438,395044,20,
400132,400154,2022-12-25_17-27-46-425996,400157,22,
405267,405287,2022-12-25_17-27-51-678792,405290,20,
410384,410435,2022-12-25_17-27-56-954014,410438,51,
415505,0,,420606,-415505,
420618,420639,2022-12-25_17-28-07-397663,420642,21,
425741,430854,2022-12-25_17-28-12-725967,430869,5113,
430890,430951,2022-12-25_17-28-17-947252,430955,61,
435970,441089,2022-12-25_17-28-23-210380,441105,5119,
441126,441164,2022-12-25_17-28-28-404638,441167,38,
446205,451326,2022-12-25_17-28-33-714289,451332,5121,
451350,451456,2022-12-25_17-28-38-936976,456463,106,
456484,456552,2022-12-25_17-28-44-147985,456555,68,
461602,461668,2022-12-25_17-28-49-381314,461671,66,
466710,471827,2022-12-25_17-28-54-809193,471835,5117,
471847,471867,2022-12-25_17-28-59-827607,471870,20,
476947,482070,2022-12-25_17-29-05-151919,482079,5123,
482090,482150,2022-12-25_17-29-10-333468,482153,60,
487178,492288,2022-12-25_17-29-15-602536,492298,5110,
492316,497428,2022-12-25_17-29-20-923853,497436,5112,
497455,497498,2022-12-25_17-29-26-040919,497503,43,
502547,507675,2022-12-25_17-29-31-366832,507684,5128,
507701,507723,2022-12-25_17-29-36-509189,507725,22,
512785,517891,2022-12-25_17-29-41-811900,517900,5106,
517912,518004,2022-12-25_17-29-47-033623,518010,92,
523022,523103,2022-12-25_17-29-52-256569,523106,81,
528131,533268,2022-12-25_17-29-57-581332,533284,5137,
533304,533324,2022-12-25_17-30-02-715201,533328,20,
538394,538414,2022-12-25_17-30-07-925571,538417,20,
543539,543560,2022-12-25_17-30-13-190473,543563,21,
548686,548720,2022-12-25_17-30-18-471378,548723,34,
553793,558915,2022-12-25_17-30-23-795682,558923,5122,
558942,559029,2022-12-25_17-30-29-018506,559038,87,
564044,564064,2022-12-25_17-30-34-174134,564067,20,
569154,574272,2022-12-25_17-30-39-565662,574287,5118,
574307,0,,579378,-574307,
579400,584523,2022-12-25_17-30-49-958591,584533,5123,
584545,589663,2022-12-25_17-30-55-234228,589679,5118,
589700,589743,2022-12-25_17-31-00-455827,589746,43,
594777,599895,2022-12-25_17-31-05-780631,599911,5118,
599929,605006,2022-12-25_17-31-11-002963,605021,5077,
605036,605056,2022-12-25_17-31-16-126020,605059,20,
610120,610162,2022-12-25_17-31-21-349440,610165,42,
615228,620353,2022-12-25_17-31-26-670652,620362,5125,
620374,620461,2022-12-25_17-31-31-893434,620464,87,
625472,625539,2022-12-25_17-31-37-080436,625542,67,
630587,630606,2022-12-25_17-31-42-264230,630609,19,
635695,635716,2022-12-25_17-31-47-491537,635719,21,
640803,640879,2022-12-25_17-31-52-783001,640882,76,
645918,651023,2022-12-25_17-31-58-041595,651038,5105,
651060,651095,2022-12-25_17-32-03-228650,651098,35,
656162,661279,2022-12-25_17-32-08-552407,661287,5117,
661303,666424,2022-12-25_17-32-13-877078,666440,5121,
666462,671532,2022-12-25_17-32-19-104580,671547,5070,
671568,671601,2022-12-25_17-32-24-220491,671604,33,
676645,681761,2022-12-25_17-32-29-549957,681775,5116,
681787,686872,2022-12-25_17-32-34-772134,686885,5085,
686905,687006,2022-12-25_17-32-39-990299,687011,101,
691978,692007,2022-12-25_17-32-45-112796,692009,29,
697100,697206,2022-12-25_17-32-50-435943,702206,106,
702218,702238,2022-12-25_17-32-55-581280,702242,20,
707355,707420,2022-12-25_17-33-00-879934,707422,65,
712453,717583,2022-12-25_17-33-06-103836,717592,5130,
717604,717626,2022-12-25_17-33-11-337681,717628,22,
722741,722762,2022-12-25_17-33-16-587194,722765,21,
727879,732995,2022-12-25_17-33-21-974582,733004,5116,
733019,738123,2022-12-25_17-33-27-232909,738133,5104,
738150,738170,2022-12-25_17-33-32-362047,738173,20,
743271,748383,2022-12-25_17-33-37-642176,748394,5112,
748406,753519,2022-12-25_17-33-42-967226,753528,5113,
753541,758663,2022-12-25_17-33-48-191935,758680,5122,
758702,758769,2022-12-25_17-33-53-441381,758771,67,
763768,768886,2022-12-25_17-33-58-838597,768901,5118,
768919,768943,2022-12-25_17-34-03-860255,768946,24,
773998,779128,2022-12-25_17-34-09-180944,779137,5130,
779148,784232,2022-12-25_17-34-14-404194,784246,5084,
784259,789359,2022-12-25_17-34-19-625846,789369,5100,
789380,794487,2022-12-25_17-34-24-953684,794497,5107,
794513,794558,2022-12-25_17-34-30-073014,794562,45,
799634,799653,2022-12-25_17-34-35-295156,799656,19,
804750,804770,2022-12-25_17-34-40-532697,804773,20,
809868,809889,2022-12-25_17-34-45-768228,809891,21,
814989,820084,2022-12-25_17-34-51-268549,820093,5095,
820105,820161,2022-12-25_17-34-56-285365,820164,56,
825202,830306,2022-12-25_17-35-01-509723,830315,5104,
830327,830370,2022-12-25_17-35-06-730712,830374,43,
835426,835481,2022-12-25_17-35-11-954330,835487,55,
840551,840576,2022-12-25_17-35-17-175617,840579,25,
845684,845703,2022-12-25_17-35-22-429204,845706,19,
850800,850883,2022-12-25_17-35-27-723461,850886,83,
855909,855995,2022-12-25_17-35-32-950833,856000,86,
861022,861104,2022-12-25_17-35-38-174379,861109,82,
866131,871262,2022-12-25_17-35-43-595663,871273,5131,
871291,871312,2022-12-25_17-35-48-634062,871315,21,
876375,876396,2022-12-25_17-35-53-845003,876399,21,
881527,881596,2022-12-25_17-35-59-159848,881599,69,
886635,886688,2022-12-25_17-36-04-374946,886692,53,
891777,891797,2022-12-25_17-36-09-608970,891800,20,
896919,902023,2022-12-25_17-36-15-033568,902036,5104,
902057,902108,2022-12-25_17-36-20-151247,902111,51,
907143,907205,2022-12-25_17-36-25-374717,907208,62,
912270,917407,2022-12-25_17-36-30-699602,917420,5137,
917442,917519,2022-12-25_17-36-35-926902,917522,77,
922527,927631,2022-12-25_17-36-41-148023,927644,5104,
927665,927719,2022-12-25_17-36-46-368462,927722,54,
932746,937873,2022-12-25_17-36-51-691635,937889,5127,
937903,937927,2022-12-25_17-36-56-815007,937930,24,
942987,948116,2022-12-25_17-37-02-136661,948128,5129,
948149,953217,2022-12-25_17-37-07-464259,953225,5068,
953238,953258,2022-12-25_17-37-12-508892,953261,20,
958399,958433,2022-12-25_17-37-17-805348,958436,34,
963501,963526,2022-12-25_17-37-23-028743,963529,25,
968631,968653,2022-12-25_17-37-28-265077,968656,22,
973738,973758,2022-12-25_17-37-33-495798,973761,20,
978866,978887,2022-12-25_17-37-38-746432,978889,21,
983983,984039,2022-12-25_17-37-44-018824,984041,56,
989081,989150,2022-12-25_17-37-49-243408,989153,69,
994189,999300,2022-12-25_17-37-54-464491,999316,5111,
999335,1004409,2022-12-25_17-37-59-817799,1004424,5074,
1004439,1009516,2022-12-25_17-38-05-112915,1009532,5077,
1009550,1014624,2022-12-25_17-38-10-256246,1014632,5074,
1014646,1019761,2022-12-25_17-38-15-456426,1019770,5115,
1019789,1024913,2022-12-25_17-38-20-780499,1024927,5124,
1024945,1024965,2022-12-25_17-38-25-915293,1024968,20,
1030028,1030063,2022-12-25_17-38-31-127653,1030067,35,
1035144,1035182,2022-12-25_17-38-36-363836,1035185,38,
1040251,1045387,2022-12-25_17-38-41-640825,1045396,5136,
1045408,1045473,2022-12-25_17-38-46-894303,1045476,65,
1050541,1050570,2022-12-25_17-38-52-115805,1050572,29,
1055668,1055689,2022-12-25_17-38-57-347587,1055692,21,
1060817,1060839,2022-12-25_17-39-02-623076,1060842,22,
1065926,1065980,2022-12-25_17-39-07-885782,1065983,54,
1071052,1071085,2022-12-25_17-39-13-108485,1071089,33,
1076184,1081309,2022-12-25_17-39-18-433487,1081325,5125,
1081347,1086418,2022-12-25_17-39-23-758099,1086433,5071,
1086455,1086488,2022-12-25_17-39-28-877395,1086491,33,
1091531,1091586,2022-12-25_17-39-34-102432,1091590,55,
1096640,1096692,2022-12-25_17-39-39-323126,1096695,52,
1101745,1101798,2022-12-25_17-39-44-547866,1101802,53,
1106878,1106908,2022-12-25_17-39-49-772697,1106913,30,
1112011,1117133,2022-12-25_17-39-55-021225,1117149,5122,
1117154,1122277,2022-12-25_17-40-00-392806,1122285,5123,
1122298,1122318,2022-12-25_17-40-05-548268,1122321,20,
1127416,1127458,2022-12-25_17-40-10-805591,1127461,42,
1132535,1137655,2022-12-25_17-40-16-191678,1137670,5120,
1137692,1142762,2022-12-25_17-40-21-411134,1142778,5070,
1142795,1142818,2022-12-25_17-40-26-531103,1142821,23,
1147873,1152979,2022-12-25_17-40-31-856814,1152994,5106,
1153013,1153133,2022-12-25_17-40-37-082776,1158086,120,
1158102,1158134,2022-12-25_17-40-42-199935,1158139,32,
1163233,1163330,2022-12-25_17-40-47-525664,1163333,97,
1168353,1168431,2022-12-25_17-40-52-746199,1168434,78,
1173462,1178602,2022-12-25_17-40-57-968222,1178611,5140,
1178624,1178645,2022-12-25_17-41-03-206179,1178648,21,
1183735,1183754,2022-12-25_17-41-08-430961,1183757,19,
1188835,1188855,2022-12-25_17-41-13-654809,1188858,20,
1193951,1193975,2022-12-25_17-41-18-891475,1193977,24,
1199060,1199081,2022-12-25_17-41-24-114758,1199084,21,
1204199,1209299,2022-12-25_17-41-29-507790,1209315,5100,
1209330,1214441,2022-12-25_17-41-34-833977,1214449,5111,
1214462,1219583,2022-12-25_17-41-40-001245,1219600,5121,
1219621,1219675,2022-12-25_17-41-45-183153,1219680,54,
1224695,1229818,2022-12-25_17-41-50-498910,1229834,5123,
1229847,1234926,2022-12-25_17-41-55-722204,1234939,5079,
1234961,1240034,2022-12-25_17-42-01-005250,1240043,5073,
1240062,1245140,2022-12-25_17-42-06-268652,1245148,5078,
1245161,1250249,2022-12-25_17-42-11-390362,1250258,5088,
1250270,1255351,2022-12-25_17-42-16-613886,1255359,5081,
1255371,1255390,2022-12-25_17-42-21-753042,1255393,19,
1260469,1265582,2022-12-25_17-42-27-263849,1265592,5113,
1265608,1265683,2022-12-25_17-42-32-279390,1265687,75,
1270704,1270781,2022-12-25_17-42-37-503287,1270784,77,
1275806,1280915,2022-12-25_17-42-42-825965,1280930,5109,
1280951,1280994,2022-12-25_17-42-47-942638,1280997,43,
1286022,1291163,2022-12-25_17-42-53-270968,1291172,5141,
1291184,1291205,2022-12-25_17-42-58-404655,1291209,21,
1296272,1301383,2022-12-25_17-43-03-717155,1301396,5111,
1301416,1306558,2022-12-25_17-43-09-040900,1306574,5142,
1306587,1311692,2022-12-25_17-43-14-264073,1311702,5105,
1311720,1316798,2022-12-25_17-43-19-591832,1316808,5078,
1316820,1316905,2022-12-25_17-43-24-710921,1316908,85,
1321911,1327027,2022-12-25_17-43-29-933044,1327043,5116,
1327064,1327110,2022-12-25_17-43-35-154515,1327116,46,
1332141,1332161,2022-12-25_17-43-40-322594,1332165,20,
1337297,1342414,2022-12-25_17-43-45-704034,1342423,5117,
1342436,1342559,2022-12-25_17-43-50-955818,1347535,123,
1347549,1347626,2022-12-25_17-43-56-147720,1347629,77,
1352656,1352728,2022-12-25_17-44-01-369043,1352734,72,
1357761,1362891,2022-12-25_17-44-06-694566,1362904,5130,
1362916,1362936,2022-12-25_17-44-11-824148,1362939,20,
1368000,1368022,2022-12-25_17-44-17-037032,1368025,22,
1373139,1378256,2022-12-25_17-44-22-358925,1378265,5117,
1378277,1378328,2022-12-25_17-44-27-570427,1378331,51,
1383382,1383437,2022-12-25_17-44-32-808203,1383440,55,
1388489,1388547,2022-12-25_17-44-38-032205,1388553,58,
1393588,1398721,2022-12-25_17-44-43-254052,1398731,5133,
1398742,1403854,2022-12-25_17-44-48-576368,1403863,5112,
1403882,1403953,2022-12-25_17-44-53-799593,1403956,71,
1408974,1414084,2022-12-25_17-44-59-021246,1414093,5110,
1414112,1419204,2022-12-25_17-45-04-346084,1419213,5092,
1419225,1419252,2022-12-25_17-45-09-467218,1419255,27,
1424323,1424381,2022-12-25_17-45-14-705463,1424384,58,
1429437,1434550,2022-12-25_17-45-20-013849,1434561,5113,
1434583,1439701,2022-12-25_17-45-25-338268,1439716,5118,
1439739,1439855,2022-12-25_17-45-30-546974,1444807,116,
1444827,1449917,2022-12-25_17-45-35-783213,1449932,5090,
1449954,1449985,2022-12-25_17-45-40-911248,1449988,31,
1455031,1460168,2022-12-25_17-45-46-228234,1460177,5137,
1460189,1460216,2022-12-25_17-45-51-375544,1460219,27,
1465283,1465389,2022-12-25_17-45-56-673368,1470431,106,
1470443,1470486,2022-12-25_17-46-01-897006,1470488,43,
1475581,1475599,2022-12-25_17-46-07-129462,1475602,18,
1480692,1480713,2022-12-25_17-46-12-364320,1480716,21,
1485806,1485901,2022-12-25_17-46-17-645245,1485904,95,
1490918,1496039,2022-12-25_17-46-22-992887,1496054,5121,
1496075,1496101,2022-12-25_17-46-28-111073,1496104,26,
1501150,1506273,2022-12-25_17-46-33-438168,1506290,5123,
1506303,1506323,2022-12-25_17-46-38-577339,1506326,20,
1511424,1516546,2022-12-25_17-46-43-974931,1516561,5122,
1516582,1521654,2022-12-25_17-46-49-204852,1521670,5072,
1521692,1521721,2022-12-25_17-46-54-328776,1521724,29,
1526767,0,,1531904,-1526767,
1531917,1531937,2022-12-25_17-47-04-789502,1531940,20,
1537034,1542164,2022-12-25_17-47-10-094584,1542179,5130,
1542201,1547272,2022-12-25_17-47-15-419717,1547287,5071,
1547303,1552379,2022-12-25_17-47-20-751580,1552394,5076,
1552411,1557511,2022-12-25_17-47-25-966769,1557520,5100,
1557532,1557560,2022-12-25_17-47-31-008216,1557563,28,
1562642,1562661,2022-12-25_17-47-36-236088,1562664,19,
1567758,1572881,2022-12-25_17-47-41-634623,1572896,5123,
1572919,1577988,2022-12-25_17-47-46-860878,1578003,5069,
1578021,1583097,2022-12-25_17-47-52-173341,1583112,5076,
1583130,1588205,2022-12-25_17-47-57-403713,1588220,5075,
1588237,1593326,2022-12-25_17-48-02-626346,1593334,5089,
1593352,1598464,2022-12-25_17-48-07-849434,1598474,5112,
1598493,1598565,2022-12-25_17-48-12-969887,1598568,72,
1603623,1608770,2022-12-25_17-48-18-294102,1608779,5147,
1608791,1608864,2022-12-25_17-48-23-517207,1608868,73,
1613913,1619032,2022-12-25_17-48-28-842633,1619041,5119,
1619053,1624176,2022-12-25_17-48-34-167080,1624184,5123,
1624204,1624273,2022-12-25_17-48-39-289126,1624277,69,
1629296,1634413,2022-12-25_17-48-44-611914,1634429,5117,
1634450,1634480,2022-12-25_17-48-49-731375,1634483,30,
1639558,1639589,2022-12-25_17-48-54-957394,1639594,31,
1644656,1644680,2022-12-25_17-49-00-169749,1644683,24,
1649783,1649879,2022-12-25_17-49-05-493009,1649882,96,
1654900,1660140,2022-12-25_17-49-10-723930,1660156,5240,
1660173,1660207,2022-12-25_17-49-16-046985,1660212,34,
1665254,1665290,2022-12-25_17-49-21-270979,1665294,36,
1670376,1675497,2022-12-25_17-49-26-596228,1675506,5121,
1675519,1680634,2022-12-25_17-49-31-921174,1680650,5115,
1680671,1685741,2022-12-25_17-49-37-078990,1685756,5070,
1685777,1685808,2022-12-25_17-49-42-259758,1685810,31,
1690855,1690912,2022-12-25_17-49-47-487108,1690917,57,
1695975,1696011,2022-12-25_17-49-52-709589,1696013,36,
1701082,1701121,2022-12-25_17-49-57-944512,1701123,39,
1706190,1706213,2022-12-25_17-50-03-154768,1706215,23,
1711327,1711348,2022-12-25_17-50-08-406506,1711351,21,
1716435,1716455,2022-12-25_17-50-13-631940,1716458,20,
1721593,1726724,2022-12-25_17-50-18-949701,1726733,5131,
1726745,1726820,2022-12-25_17-50-24-248354,1726823,75,
1731849,1736952,2022-12-25_17-50-29-471519,1736962,5103,
1736976,1737035,2022-12-25_17-50-34-693732,1737039,59,
1742086,1742140,2022-12-25_17-50-39-915727,1742143,54,
1747233,1747335,2022-12-25_17-50-45-240585,1752341,102,
1752353,1752373,2022-12-25_17-50-50-390264,1752376,20,
1757452,1762557,2022-12-25_17-50-55-688957,1762567,5105,
1762584,1762605,2022-12-25_17-51-00-866677,1762608,21,
1767708,1772828,2022-12-25_17-51-06-215819,1772837,5120,
1772849,1777969,2022-12-25_17-51-11-455316,1777978,5120,
1777990,1783110,2022-12-25_17-51-16-781293,1783125,5120,
1783143,1783164,2022-12-25_17-51-21-916269,1783167,21,
1788222,1793333,2022-12-25_17-51-27-225097,1793342,5111,
1793355,1798477,2022-12-25_17-51-32-371604,1798494,5122,
1798515,1803620,2022-12-25_17-51-37-773201,1803636,5105,
1803651,1808729,2022-12-25_17-51-42-995057,1808743,5078,
1808761,1813837,2022-12-25_17-51-48-323491,1813851,5076,
1813870,1818988,2022-12-25_17-51-53-542820,1818996,5118,
1819008,1824136,2022-12-25_17-51-58-662219,1824152,5128,
1824167,1824280,2022-12-25_17-52-03-940540,1829242,113,
1829257,1834382,2022-12-25_17-52-09-311505,1834391,5125,
1834404,1834486,2022-12-25_17-52-14-435895,1834489,82,
1839524,1844643,2022-12-25_17-52-19-730522,1844659,5119,
1844679,1844783,2022-12-25_17-52-24-979374,1849751,104,
1849765,1849789,2022-12-25_17-52-30-105719,1849792,24,
1854865,1860003,2022-12-25_17-52-35-526521,1860012,5138,
1860024,1860086,2022-12-25_17-52-40-646562,1860089,62,
1865123,1870239,2022-12-25_17-52-45-972679,1870248,5116,
1870260,1875353,2022-12-25_17-52-51-195884,1875369,5093,
1875390,1880454,2022-12-25_17-52-56-493354,1880463,5064,
1880479,1885605,2022-12-25_17-53-01-741985,1885614,5126,
1885636,1885700,2022-12-25_17-53-06-862723,1885703,64,
1890718,1895827,2022-12-25_17-53-12-189233,1895837,5109,
1895849,1900973,2022-12-25_17-53-17-412246,1900989,5124,
1901001,1906107,2022-12-25_17-53-22-631361,1906115,5106,
1906128,1906214,2022-12-25_17-53-27-857759,1906217,86,
1911272,1916412,2022-12-25_17-53-33-181040,1916421,5140,
1916434,1921574,2022-12-25_17-53-38-503959,1921589,5140,
1921606,1926716,2022-12-25_17-53-43-726338,1926724,5110,
1926738,1931846,2022-12-25_17-53-49-051116,1931855,5108,
1931871,1931916,2022-12-25_17-53-54-171886,1931919,45,
1937004,1942105,2022-12-25_17-53-59-496955,1942120,5101,
1942133,1942179,2022-12-25_17-54-04-665840,1942182,46,
1947238,1952344,2022-12-25_17-54-09-940931,1952352,5106,
1952369,1957451,2022-12-25_17-54-15-265432,1957462,5082,
1957484,1962562,2022-12-25_17-54-20-454267,1962577,5078,
1962599,1967671,2022-12-25_17-54-25-710338,1967688,5072,
1967708,1967745,2022-12-25_17-54-30-833400,1967748,37,
1972787,1977890,2022-12-25_17-54-36-156938,1977905,5103,
1977921,1977947,2022-12-25_17-54-41-280331,1977949,26,
1983003,1988130,2022-12-25_17-54-46-601817,1988145,5127,
1988158,1988178,2022-12-25_17-54-51-746112,1988181,20,
1993277,1998403,2022-12-25_17-54-57-046454,1998412,5126,
1998424,1998454,2022-12-25_17-55-02-267607,1998457,30,
2003521,2003560,2022-12-25_17-55-07-490919,2003564,39,
2008640,2013745,2022-12-25_17-55-12-816048,2013754,5105,
2013766,2013869,2022-12-25_17-55-18-003684,2018885,103,
2018906,2024026,2022-12-25_17-55-23-372058,2024041,5120,
2024062,2024083,2022-12-25_17-55-28-494589,2024086,21,
2029139,2034274,2022-12-25_17-55-33-810951,2034282,5135,
2034294,2034395,2022-12-25_17-55-39-035768,2034401,101,
2039418,2044549,2022-12-25_17-55-44-356296,2044563,5131,
2044575,2044595,2022-12-25_17-55-49-490689,2044599,20,
2049676,2049772,2022-12-25_17-55-54-790271,2049775,96,
2054826,2059959,2022-12-25_17-56-00-023045,2059971,5133,
2059983,2060004,2022-12-25_17-56-05-264382,2060007,21,
2065089,2065109,2022-12-25_17-56-10-491076,2065112,20,
2070212,2070284,2022-12-25_17-56-15-792990,2070287,72,
2075334,2075393,2022-12-25_17-56-21-016268,2075396,59,
2080469,2080506,2022-12-25_17-56-26-243299,2080509,37,
2085618,2085703,2022-12-25_17-56-31-568954,2085706,85,
2090750,2090815,2022-12-25_17-56-36-787732,2090821,65,
2095889,2095918,2022-12-25_17-56-42-007508,2095921,29,
2100990,2106117,2022-12-25_17-56-47-332768,2106126,5127,
2106138,2106217,2022-12-25_17-56-52-556922,2106220,79,
2111228,2111248,2022-12-25_17-56-57-710371,2111250,20,
2116357,2121488,2022-12-25_17-57-03-102250,2121502,5131,
2121514,2126620,2022-12-25_17-57-08-264836,2126628,5106,
2126641,2126724,2022-12-25_17-57-13-546797,2126727,83,
2131730,2136847,2022-12-25_17-57-18-769648,2136863,5117,
2136885,2136936,2022-12-25_17-57-23-995177,2136941,51,
2141952,2147071,2022-12-25_17-57-29-215186,2147086,5119,
2147108,2152177,2022-12-25_17-57-34-540483,2152193,5069,
2152215,2157280,2022-12-25_17-57-39-863949,2157289,5065,
2157302,2157345,2022-12-25_17-57-44-883881,2157348,43,
2162399,2167528,2022-12-25_17-57-50-207818,2167537,5129,
2167555,2172674,2022-12-25_17-57-55-431199,2172690,5119,
2172710,2177780,2022-12-25_17-58-00-754051,2177795,5070,
2177817,2182890,2022-12-25_17-58-05-979588,2182908,5073,
2182929,2182959,2022-12-25_17-58-11-101507,2182963,30,
2188004,2188065,2022-12-25_17-58-16-322867,2188070,61,
2193111,2198243,2022-12-25_17-58-21-746662,2198255,5132,
2198267,2198294,2022-12-25_17-58-26-782553,2198297,27,
2203349,2203368,2022-12-25_17-58-31-990168,2203371,19,
2208484,2208568,2022-12-25_17-58-37-311856,2208570,84,
2213594,2213673,2022-12-25_17-58-42-534821,2213676,79,
2218703,2218723,2022-12-25_17-58-47-708826,2218726,20,
2223811,2223881,2022-12-25_17-58-52-978891,2223884,70,
2228919,2234050,2022-12-25_17-58-58-201331,2234066,5131,
2234078,2239177,2022-12-25_17-59-03-526644,2239186,5099,
2239203,2244306,2022-12-25_17-59-08-783078,2244315,5103,
2244329,2244399,2022-12-25_17-59-13-972216,2244401,70,
2249424,2254558,2022-12-25_17-59-19-295843,2254575,5134,
2254589,2254609,2022-12-25_17-59-24-428030,2254613,20,
2259671,2264802,2022-12-25_17-59-29-742127,2264812,5131,
2264829,2269958,2022-12-25_17-59-35-065421,2269973,5129,
2269988,2275099,2022-12-25_17-59-40-288160,2275108,5111,
2275120,2275209,2022-12-25_17-59-45-507109,2275212,89,
2280227,2285361,2022-12-25_17-59-50-835870,2285377,5134,
2285392,2290503,2022-12-25_17-59-56-058055,2290512,5111,
2290524,2290544,2022-12-25_18-00-01-216757,2290547,20,
2295612,2300717,2022-12-25_18-00-06-503211,2300726,5105,
2300745,2305866,2022-12-25_18-00-11-808262,2305881,5121,
2305908,2305929,2022-12-25_18-00-16-954357,2305931,21,
2310978,2316118,2022-12-25_18-00-22-273221,2316127,5140,
2316139,2321264,2022-12-25_18-00-27-497199,2321279,5125,
2321302,2326369,2022-12-25_18-00-32-781022,2326378,5067,
2326390,2326411,2022-12-25_18-00-37-916195,2326415,21,
2331524,2331630,2022-12-25_18-00-43-265321,2336631,106,
2336644,2336730,2022-12-25_18-00-48-487478,2336733,86,
2341763,2346888,2022-12-25_18-00-53-812899,2346904,5125,
2346918,2351990,2022-12-25_18-00-59-034904,2351999,5072,
2352010,2352042,2022-12-25_18-01-04-157959,2352045,32,
2357110,2357149,2022-12-25_18-01-09-378419,2357154,39,
2362208,2362252,2022-12-25_18-01-14-600211,2362256,44,
2367338,2372456,2022-12-25_18-01-19-925516,2372465,5118,
2372483,2372554,2022-12-25_18-01-25-148002,2372557,71,
2377605,2382736,2022-12-25_18-01-30-474660,2382745,5131,
2382757,2382777,2022-12-25_18-01-35-613983,2382780,20,
2387887,2392986,2022-12-25_18-01-41-122522,2392995,5099,
2393014,2393070,2022-12-25_18-01-46-142226,2393074,56,
2398143,2403256,2022-12-25_18-01-51-464704,2403264,5113,
2403276,2408407,2022-12-25_18-01-56-689031,2408422,5131,
2408444,2413515,2022-12-25_18-02-02-013372,2413531,5071,
2413552,2418623,2022-12-25_18-02-07-233934,2418639,5071,
2418654,2423729,2022-12-25_18-02-12-457292,2423744,5075,
2423763,2423889,2022-12-25_18-02-17-682148,2428840,126,
2428862,2428896,2022-12-25_18-02-22-800826,2428899,34,
2433956,2433995,2022-12-25_18-02-28-023436,2433997,39,
2439091,2439112,2022-12-25_18-02-33-260372,2439115,21,
2444202,2444222,2022-12-25_18-02-38-494606,2444225,20,
2449320,2454437,2022-12-25_18-02-43-896608,2454452,5117,
2454474,2459545,2022-12-25_18-02-49-117589,2459561,5071,
2459580,2464654,2022-12-25_18-02-54-543621,2464669,5074,
2464684,2469759,2022-12-25_18-02-59-663522,2469768,5075,
2469784,2474874,2022-12-25_18-03-04-787158,2474887,5090,
2474906,2474926,2022-12-25_18-03-09-922819,2474930,20,
2479988,2485100,2022-12-25_18-03-15-230280,2485108,5112,
2485120,2485141,2022-12-25_18-03-20-375962,2485144,21,
2490244,2495361,2022-12-25_18-03-25-776539,2495376,5117,
2495396,2495428,2022-12-25_18-03-30-897289,2495432,32,
2500475,2505570,2022-12-25_18-03-36-220867,2505581,5095,
2505603,2505630,2022-12-25_18-03-41-342315,2505632,27,
2510691,2510735,2022-12-25_18-03-46-565788,2510738,44,
2515817,2515838,2022-12-25_18-03-51-796852,2515842,21,
2520926,2526035,2022-12-25_18-03-57-111468,2526045,5109,
2526057,2526133,2022-12-25_18-04-02-333955,2526136,76,
2531148,2531168,2022-12-25_18-04-07-491044,2531172,20,
2536267,2536341,2022-12-25_18-04-12-778188,2536343,74,
2541403,2541445,2022-12-25_18-04-18-001720,2541449,42,
2546509,2546548,2022-12-25_18-04-23-224526,2546552,39,
2551652,2556757,2022-12-25_18-04-28-548781,2556767,5105,
2556782,2561865,2022-12-25_18-04-33-874313,2561876,5083,
2561897,2566976,2022-12-25_18-04-39-100726,2566991,5079,
2567012,2572088,2022-12-25_18-04-44-318798,2572103,5076,
2572124,2577199,2022-12-25_18-04-49-544163,2577207,5075,
2577219,2582348,2022-12-25_18-04-54-766434,2582357,5129,
2582370,2587485,2022-12-25_18-04-59-986920,2587501,5115,
2587521,2592593,2022-12-25_18-05-05-310796,2592610,5072,
2592631,2592668,2022-12-25_18-05-10-431698,2592670,37,
2597697,2597776,2022-12-25_18-05-15-656478,2597779,79,
2602814,2607917,2022-12-25_18-05-20-978358,2607932,5103,
2607952,2613024,2022-12-25_18-05-26-201102,2613039,5072,
2613059,2613081,2022-12-25_18-05-31-324805,2613084,22,
2618139,2623241,2022-12-25_18-05-36-627902,2623257,5102,
2623272,2623293,2022-12-25_18-05-41-768469,2623297,21,
2628355,2633472,2022-12-25_18-05-47-090903,2633481,5117,
2633493,2638614,2022-12-25_18-05-52-312583,2638630,5121,
2638650,2638704,2022-12-25_18-05-57-536734,2638709,54,
2643748,2648850,2022-12-25_18-06-02-860600,2648866,5102,
2648884,2648997,2022-12-25_18-06-08-081600,2653966,113,
2653984,2654011,2022-12-25_18-06-13-212467,2654014,27,
2659103,2659126,2022-12-25_18-06-18-448191,2659129,23,
2664212,2664233,2022-12-25_18-06-23-676972,2664236,21,
2669334,2669356,2022-12-25_18-06-28-915843,2669359,22,
2674442,2674463,2022-12-25_18-06-34-142386,2674466,21,
2679597,2679621,2022-12-25_18-06-39-422909,2679624,24,
2684736,2684754,2022-12-25_18-06-44-682008,2684757,18,
2689846,2689930,2022-12-25_18-06-49-967643,2689937,84,
2694960,2700078,2022-12-25_18-06-55-291051,2700094,5118,
2700114,2700224,2022-12-25_18-07-00-512441,2705186,110,
2705206,2710294,2022-12-25_18-07-05-635755,2710310,5088,
2710334,2715412,2022-12-25_18-07-11-059272,2715421,5078,
2715432,2715537,2022-12-25_18-07-16-150833,2720569,105,
2720590,2720638,2022-12-25_18-07-21-401858,2720640,48,
2725672,2725693,2022-12-25_18-07-26-578291,2725696,21,
2730815,2735943,2022-12-25_18-07-31-949614,2735952,5128,
2735964,2736045,2022-12-25_18-07-37-172753,2736049,81,
2741089,2746211,2022-12-25_18-07-42-499662,2746225,5122,
2746236,2746346,2022-12-25_18-07-47-704809,2751324,110,
2751336,2756448,2022-12-25_18-07-52-941861,2756457,5112,
2756477,2761556,2022-12-25_18-07-58-266493,2761565,5079,
2761582,2766685,2022-12-25_18-08-03-591263,2766694,5103,
2766714,2766761,2022-12-25_18-08-08-611378,2766765,47,
2771805,2771869,2022-12-25_18-08-13-837897,2771875,64,
2776945,2776972,2022-12-25_18-08-19-058471,2776976,27,
2782073,2787177,2022-12-25_18-08-24-379186,2787186,5104,
2787208,2792341,2022-12-25_18-08-29-703599,2792350,5133,
2792362,2797472,2022-12-25_18-08-35-030564,2797480,5110,
2797493,2797582,2022-12-25_18-08-40-140351,2797585,89,
2802616,2807751,2022-12-25_18-08-45-476496,2807762,5135,
2807774,2807794,2022-12-25_18-08-50-612765,2807797,20,
2812885,2817989,2022-12-25_18-08-55-922843,2818000,5104,
2818021,2823098,2022-12-25_18-09-01-220014,2823114,5077,
2823136,2823182,2022-12-25_18-09-06-364408,2823186,46,
2828218,2828298,2022-12-25_18-09-11-594639,2828302,80,
2833347,2838472,2022-12-25_18-09-16-915111,2838480,5125,
2838493,2838519,2022-12-25_18-09-22-056192,2838523,26,
2843624,2843644,2022-12-25_18-09-27-299931,2843647,20,
2848771,2853879,2022-12-25_18-09-32-681044,2853891,5108,
2853903,2859012,2022-12-25_18-09-37-903870,2859020,5109,
2859039,2859112,2022-12-25_18-09-43-128163,2859116,73,
2864124,2869236,2022-12-25_18-09-48-348682,2869251,5112,
2869273,2874344,2022-12-25_18-09-53-673490,2874359,5071,
2874380,2879452,2022-12-25_18-09-58-898122,2879468,5072,
2879487,2884559,2022-12-25_18-10-04-070946,2884575,5072,
2884595,2889669,2022-12-25_18-10-09-442904,2889684,5074,
2889705,2894785,2022-12-25_18-10-14-665206,2894797,5080,
2894810,2899893,2022-12-25_18-10-19-782500,2899909,5083,
2899921,2900033,2022-12-25_18-10-24-974467,2905013,112,
2905025,2905046,2022-12-25_18-10-30-150633,2905049,21,
2910136,2915246,2022-12-25_18-10-35-453346,2915255,5110,
2915274,