RD,TS_received,TS_sent,AK,RoundTrip,
53688,58792,2023-11-07_14-50-19-960947,58795,5104,
58795,63916,2023-11-07_14-50-25-286174,63919,5121,
63919,69041,2023-11-07_14-50-30-246031,69049,5122,
69061,69088,2023-11-07_14-50-35-409270,69091,27,
74152,79269,2023-11-07_14-50-41-111332,79278,5117,
79289,84408,2023-11-07_14-50-46-116800,84417,5119,
84429,89514,2023-11-07_14-50-51-234903,89523,5085,
89535,94643,2023-11-07_14-50-56-454731,94651,5108,
94664,99767,2023-11-07_14-51-02-043422,99769,5103,
99770,
104868,
109976,
158638,163755,2023-11-07_14-52-07-282211,163757,5117,
163758,163789,2023-11-07_14-52-12-355219,163815,31,
168854,173973,2023-11-07_14-52-18-172421,173976,5119,
173976,179080,2023-11-07_14-52-23-612396,179083,5104,
179083,184210,2023-11-07_14-52-28-438566,184213,5127,
184214,189317,2023-11-07_14-52-34-284313,189321,5103,
189322,194426,2023-11-07_14-52-39-955023,194429,5104,
194429,199535,2023-11-07_14-52-45-303903,199538,5106,
199538,
204653,209768,2023-11-07_14-52-54-947058,209777,5115,
209790,214915,2023-11-07_14-53-00-664728,214923,5125,
214935,0,,220071,-214935,
220071,225187,2023-11-07_14-53-11-067844,225196,5116,
225209,230304,2023-11-07_14-53-16-704573,230313,5095,
230325,235414,2023-11-07_14-53-21-976333,235423,5089,
235435,240540,2023-11-07_14-53-26-704898,240549,5105,
240561,
245640,250763,2023-11-07_14-53-37-242008,250766,5123,
250767,255872,2023-11-07_14-53-42-678405,255874,5105,
255875,0,,260989,-255875,
261001,266096,2023-11-07_14-53-53-331721,266105,5095,
266117,271203,2023-11-07_14-53-58-823734,271207,5086,
271207,276313,2023-11-07_14-54-03-854869,276322,5106,
276334,
281439,0,,286549,-281439,
286556,291698,2023-11-07_14-54-19-065173,291701,5142,
291701,296813,2023-11-07_14-54-24-160836,296816,5112,
296816,301920,2023-11-07_14-54-30-104741,301923,5104,
301923,307029,2023-11-07_14-54-35-241127,307038,5106,
307041,312149,2023-11-07_14-54-40-291535,312159,5108,
312171,317285,2023-11-07_14-54-46-087478,317293,5114,
317305,322436,2023-11-07_14-54-51-021093,322444,5131,
322456,327567,2023-11-07_14-54-56-308148,327570,5111,
327570,0,,332676,-327570,
332689,337820,2023-11-07_14-55-06-918849,337828,5131,
337840,342927,2023-11-07_14-55-12-131109,342936,5087,
342948,348035,2023-11-07_14-55-16-878121,348044,5087,
348056,353143,2023-11-07_14-55-21-816275,353152,5087,
353164,
358260,363382,2023-11-07_14-55-32-465803,363385,5122,
363385,368516,2023-11-07_14-55-37-609463,368518,5131,
368519,373652,2023-11-07_14-55-42-901743,373661,5133,
373673,378781,2023-11-07_14-55-48-759063,378784,5108,
378784,383888,2023-11-07_14-55-53-599800,383897,5104,
383909,388996,2023-11-07_14-55-59-123141,388999,5087,
388999,394103,2023-11-07_14-56-04-140017,394113,5104,
394124,
399226,404373,2023-11-07_14-56-15-356764,404382,5147,
404395,
409503,
414629,419745,2023-11-07_14-56-29-887718,419748,5116,
419748,424870,2023-11-07_14-56-35-718094,424880,5122,
424892,
429970,435091,2023-11-07_14-56-45-979209,435094,5121,
435094,440215,2023-11-07_14-56-50-761078,440223,5121,
440236,0,,445316,-440236,
445316,450430,2023-11-07_14-57-01-715435,450440,5114,
450452,455538,2023-11-07_14-57-07-432469,455541,5086,
455541,460646,2023-11-07_14-57-12-536399,460655,5105,
460668,465789,2023-11-07_14-57-18-003216,465799,5121,
465811,0,,470903,-465811,
470903,476017,2023-11-07_14-57-28-356841,476020,5114,
476020,481133,2023-11-07_14-57-33-375219,481136,5113,
481136,486250,2023-11-07_14-57-38-314141,486259,5114,
486272,491384,2023-11-07_14-57-45-141430,491386,5112,
491387,496500,2023-11-07_14-57-49-477282,496503,5113,
496503,
501600,506717,2023-11-07_14-57-59-081685,506726,5117,
506738,511844,2023-11-07_14-58-04-656402,511853,5106,
511865,516980,2023-11-07_14-58-09-549465,516988,5115,
517001,522112,2023-11-07_14-58-14-960447,522121,5111,
522133,527220,2023-11-07_14-58-20-138513,527229,5087,
527242,532342,2023-11-07_14-58-25-504195,532351,5100,
532355,537466,2023-11-07_14-58-31-083317,537468,5111,
537469,542577,2023-11-07_14-58-36-258421,542580,5108,
542580,547722,2023-11-07_14-58-41-165541,547730,5142,
547742,552830,2023-11-07_14-58-47-373860,552832,5088,
552833,
557929,563045,2023-11-07_14-58-57-080400,563048,5116,
563048,568176,2023-11-07_14-59-02-053335,568185,5128,
568198,573311,2023-11-07_14-59-07-733087,573313,5113,
573314,578426,2023-11-07_14-59-13-286457,578429,5112,
578429,583533,2023-11-07_14-59-18-246840,583543,5104,
583555,588684,2023-11-07_14-59-22-990042,588693,5129,
588705,593815,2023-11-07_14-59-28-139693,593817,5110,
593818,598942,2023-11-07_14-59-33-064772,598946,5124,
598946,604056,2023-11-07_14-59-38-367799,604059,5110,
604059,609216,2023-11-07_14-59-43-574659,609225,5157,
609237,609261,2023-11-07_14-59-48-375298,609264,24,
614322,619431,2023-11-07_14-59-54-092429,619435,5109,
619435,
624551,
629659,634776,2023-11-07_15-00-11-134641,634791,5117,
634803,639920,2023-11-07_15-00-16-043308,639923,5117,
639924,645028,2023-11-07_15-00-20-912826,645037,5104,
645049,
650161,655276,2023-11-07_15-00-32-339185,655280,5115,
655280,660400,2023-11-07_15-00-37-166829,660408,5120,
660420,665507,2023-11-07_15-00-43-004344,665509,5087,
665510,670614,2023-11-07_15-00-47-571778,670618,5104,
670618,675728,2023-11-07_15-00-53-148701,675732,5110,
675732,
680842,685967,2023-11-07_15-01-04-107842,685977,5125,
685990,691107,2023-11-07_15-01-08-877356,691116,5117,
691127,696232,2023-11-07_15-01-13-724720,696241,5105,
696252,701350,2023-11-07_15-01-19-266310,701352,5098,
701353,706477,2023-11-07_15-01-24-752482,706480,5124,
706480,
711597,716724,2023-11-07_15-01-35-598094,716727,5127,
716728,721832,2023-11-07_15-01-39-999508,721840,5104,
721853,726967,2023-11-07_15-01-45-289385,726977,5114,
726989,732097,2023-11-07_15-01-50-886154,732099,5108,
732100,
737217,
742336,747463,2023-11-07_15-02-06-691814,747472,5127,
747485,752593,2023-11-07_15-02-11-139295,752596,5108,
752596,757700,2023-11-07_15-02-16-770201,757709,5104,
757721,762809,2023-11-07_15-02-22-723246,762817,5088,
762829,767916,2023-11-07_15-02-27-316770,767920,5087,
767920,773093,2023-11-07_15-02-33-191316,773108,5173,
773121,
778199,783315,2023-11-07_15-02-43-653574,783317,5116,
783318,
788421,793566,2023-11-07_15-02-53-893709,793576,5145,
793588,798674,2023-11-07_15-02-59-087920,798677,5086,
798677,803796,2023-11-07_15-03-05-196455,803799,5119,
803799,808904,2023-11-07_15-03-10-567146,808913,5105,
808925,814031,2023-11-07_15-03-14-556766,814034,5106,
814034,819146,2023-11-07_15-03-19-910469,819156,5112,
819168,
824260,829402,2023-11-07_15-03-30-133702,829412,5142,
829424,834546,2023-11-07_15-03-35-451100,834555,5122,
834567,839684,2023-11-07_15-03-40-982249,839687,5117,
839687,844815,2023-11-07_15-03-45-064418,844824,5128,
844836,
849947,
855055,860171,2023-11-07_15-04-01-907643,860173,5116,
860174,865279,2023-11-07_15-04-06-111491,865282,5105,
865282,870415,2023-11-07_15-04-12-558365,870417,5133,
870418,
875514,880630,2023-11-07_15-04-22-860142,880639,5116,
880652,
885757,
890865,895981,2023-11-07_15-04-39-083341,895984,5116,
895984,901090,2023-11-07_15-04-43-714525,901099,5106,
901112,906224,2023-11-07_15-04-48-761579,906233,5112,
906245,911360,2023-11-07_15-04-54-300469,911370,5115,
911382,
916473,921588,2023-11-07_15-05-04-594903,921591,5115,
921591,
926692,931820,2023-11-07_15-05-15-523329,931823,5128,
931823,936959,2023-11-07_15-05-20-200027,936961,5136,
936962,942070,2023-11-07_15-05-25-989972,942072,5108,
942073,947193,2023-11-07_15-05-31-054077,947195,5120,
947196,
952292,957407,2023-11-07_15-05-41-439142,957411,5115,
957412,
962508,967660,2023-11-07_15-05-51-222362,967669,5152,
967681,
972759,
977891,983008,2023-11-07_15-06-07-554207,983018,5117,
983030,0,,988120,-983030,
988120,993234,2023-11-07_15-06-16-840896,993237,5114,
993237,0,,998337,-993237,
998337,1003451,2023-11-07_15-06-28-246623,1003459,5114,
1003471,
1008572,1013691,2023-11-07_15-06-38-164264,1013700,5119,
1013711,
1018822,1023942,2023-11-07_15-06-49-937989,1023945,5120,
1023945,
1029041,
1034149,0,,1039277,-1034149,
1039277,1044390,2023-11-07_15-07-09-510514,1044399,5113,
1044412,1049514,2023-11-07_15-07-15-246513,1049523,5102,
1049535,1054635,2023-11-07_15-07-20-912172,1054644,5100,
1054648,1059761,2023-11-07_15-07-26-068706,1059764,5113,
1059764,1064884,2023-11-07_15-07-30-756401,1064893,5120,
1064905,0,,1070010,-1064905,
1070011,1075125,2023-11-07_15-07-41-773335,1075133,5114,
1075145,
1080225,1085341,2023-11-07_15-07-52-342828,1085344,5116,
1085344,1090449,2023-11-07_15-07-57-408115,1090458,5105,
1090470,
1095578,1100695,2023-11-07_15-08-07-882287,1100697,5117,
1100698,1105810,2023-11-07_15-08-13-773561,1105813,5112,
1105813,1110920,2023-11-07_15-08-18-300945,1110929,5107,
1110942,
1116020,
1121128,1126245,2023-11-07_15-08-34-540766,1126248,5117,
1126248,1131352,2023-11-07_15-08-39-162291,1131355,5104,
1131356,1136474,2023-11-07_15-08-44-650862,1136484,5118,
1136496,
1141596,
1146703,1151819,2023-11-07_15-08-59-885761,1151823,5116,
1151824,1156934,2023-11-07_15-09-06-058196,1156937,5110,
1156937,1162050,2023-11-07_15-09-10-890121,1162058,5113,
1162071,1167179,2023-11-07_15-09-16-542448,1167182,5108,
1167182,1172287,2023-11-07_15-09-21-868939,1172290,5105,
1172290,1177399,2023-11-07_15-09-26-972470,1177402,5109,
1177402,1182530,2023-11-07_15-09-31-779543,1182539,5128,
1182552,1187637,2023-11-07_15-09-37-198048,1187646,5085,
1187664,1192746,2023-11-07_15-09-42-703131,1192754,5082,
1192767,1197862,2023-11-07_15-09-47-918939,1197865,5095,
1197866,
1202976,1208092,2023-11-07_15-09-57-141229,1208101,5116,
1208114,1213330,2023-11-07_15-10-03-250853,1213333,5216,
1213334,
1218464,1223587,2023-11-07_15-10-13-922186,1223590,5123,
1223590,1228703,2023-11-07_15-10-18-655782,1228718,5113,
1228731,1233833,2023-11-07_15-10-24-064911,1233837,5102,
1233837,1238972,2023-11-07_15-10-29-599525,1238980,5135,
1238993,
1244104,
1249212,1254327,2023-11-07_15-10-45-320098,1254331,5115,
1254331,1259467,2023-11-07_15-10-50-229446,1259476,5136,
1259488,1264606,2023-11-07_15-10-55-508208,1264609,5118,
1264609,
1269706,1274821,2023-11-07_15-11-06-525547,1274832,5115,
1274844,1279947,2023-11-07_15-11-11-688593,1279957,5103,
1279968,
1285046,
1290154,1295269,2023-11-07_15-11-27-014169,1295272,5115,
1295274,1300379,2023-11-07_15-11-32-262152,1300382,5105,
1300382,
1305510,1310626,2023-11-07_15-11-42-476810,1310629,5116,
1310629,1315736,2023-11-07_15-11-48-320167,1315739,5107,
1315739,1320897,2023-11-07_15-11-52-858038,1320905,5158,
1320917,