RD,TS_received,TS_sent,AK,RoundTrip,
55397,55469,2022-12-28_09-38-25-783530,55472,72,
60516,60564,2022-12-28_09-38-31-006447,60566,48,
65634,65678,2022-12-28_09-38-36-233484,65681,44,
70732,70752,2022-12-28_09-38-41-435574,70755,20,
75865,75885,2022-12-28_09-38-46-688903,75888,20,
80972,80992,2022-12-28_09-38-51-913347,80994,20,
86110,86130,2022-12-28_09-38-57-183332,86133,20,
91228,91281,2022-12-28_09-39-02-447496,91287,53,
96336,96384,2022-12-28_09-39-07-667954,96387,48,
101443,101488,2022-12-28_09-39-12-888650,101491,45,
106552,106600,2022-12-28_09-39-18-110785,106604,48,
111660,111692,2022-12-28_09-39-23-333410,111696,32,
116759,116780,2022-12-28_09-39-28-543596,116782,21,
121911,121932,2022-12-28_09-39-33-819578,121935,21,
127047,127108,2022-12-28_09-39-39-108579,127113,61,
132146,132174,2022-12-28_09-39-44-294535,132176,28,
137264,137307,2022-12-28_09-39-49-545230,137310,43,
142370,142389,2022-12-28_09-39-54-749114,142393,19,
147512,147598,2022-12-28_09-40-00-088207,147601,86,
152619,152639,2022-12-28_09-40-05-249806,152642,20,
157767,157787,2022-12-28_09-40-10-525477,157790,20,
162886,162919,2022-12-28_09-40-15-791345,162922,33,
167993,168014,2022-12-28_09-40-21-004178,168017,21,
173130,173159,2022-12-28_09-40-26-280668,173163,29,
178241,178291,2022-12-28_09-40-31-532679,178293,50,
183354,183391,2022-12-28_09-40-36-759903,183396,37,
188455,188486,2022-12-28_09-40-41-977786,188491,31,
193601,193621,2022-12-28_09-40-47-228947,193624,20,
198717,198791,2022-12-28_09-40-52-519349,198794,74,
203823,203903,2022-12-28_09-40-57-742138,203906,80,
208928,209010,2022-12-28_09-41-02-970058,209013,82,
214041,214110,2022-12-28_09-41-08-180269,214112,69,
219172,219226,2022-12-28_09-41-13-418761,219231,54,
224298,224326,2022-12-28_09-41-18-632713,224329,28,
229409,229429,2022-12-28_09-41-23-863230,229433,20,
234547,234569,2022-12-28_09-41-29-124756,234571,22,
239690,239757,2022-12-28_09-41-34-424774,239762,67,
244795,244815,2022-12-28_09-41-39-620038,244818,20,
249915,249946,2022-12-28_09-41-44-867676,249952,31,
255023,255119,2022-12-28_09-41-50-171936,255122,96,
260137,260212,2022-12-28_09-41-55-391699,260215,75,
265253,265310,2022-12-28_09-42-00-620365,265313,57,
270397,270417,2022-12-28_09-42-05-851600,270420,20,
275502,275524,2022-12-28_09-42-11-082644,275526,22,
280610,280632,2022-12-28_09-42-16-311378,280635,22,
285732,285799,2022-12-28_09-42-21-609027,285802,67,
290862,290903,2022-12-28_09-42-26-841542,290906,41,
295988,296009,2022-12-28_09-42-32-074599,296012,21,
301088,301110,2022-12-28_09-42-37-290633,301112,22,
306205,306299,2022-12-28_09-42-42-602380,306302,94,
311336,311356,2022-12-28_09-42-47-777608,311358,20,
316460,316515,2022-12-28_09-42-53-054759,316520,55,
321594,321614,2022-12-28_09-42-58-280774,321617,20,
326708,326740,2022-12-28_09-43-03-508596,326744,32,
331816,331837,2022-12-28_09-43-08-735733,331841,21,
336925,337026,2022-12-28_09-43-14-037553,337029,101,
342032,342139,2022-12-28_09-43-19-273548,347143,107,
347159,347229,2022-12-28_09-43-24-488618,347232,70,
352292,352357,2022-12-28_09-43-29-736255,352361,65,
357421,357441,2022-12-28_09-43-34-956901,357444,20,
362554,367666,2022-12-28_09-43-40-379649,367671,5112,
367672,367736,2022-12-28_09-43-45-490438,367739,64,
372814,372847,2022-12-28_09-43-50-702365,372850,33,
377926,377946,2022-12-28_09-43-55-933974,377949,20,
383031,383051,2022-12-28_09-44-01-154724,383054,20,
388182,388204,2022-12-28_09-44-06-436586,388208,22,
393298,393316,2022-12-28_09-44-11-673766,393319,18,
398423,398450,2022-12-28_09-44-16-926325,398453,27,
403547,403644,2022-12-28_09-44-22-236967,403647,97,
408660,408753,2022-12-28_09-44-27-465596,408756,93,
413783,413859,2022-12-28_09-44-32-691267,413862,76,
418891,418945,2022-12-28_09-44-37-913642,418950,54,
424000,424054,2022-12-28_09-44-43-133233,424060,54,
429113,429170,2022-12-28_09-44-48-359606,429175,57,
434212,434255,2022-12-28_09-44-53-577799,434258,43,
439319,439340,2022-12-28_09-44-58-787753,439343,21,
444462,444483,2022-12-28_09-45-04-041217,444492,21,
449577,449666,2022-12-28_09-45-09-348064,449671,89,
454688,454711,2022-12-28_09-45-14-517146,454713,23,
459806,459871,2022-12-28_09-45-19-787275,459873,65,
464904,464931,2022-12-28_09-45-24-966000,464934,27,
470022,470070,2022-12-28_09-45-30-232536,470072,48,
475129,475199,2022-12-28_09-45-35-476533,475204,70,
480238,480288,2022-12-28_09-45-40-691444,480292,50,
485346,485392,2022-12-28_09-45-45-911915,485397,46,
490454,490485,2022-12-28_09-45-51-133541,490488,31,
495562,495591,2022-12-28_09-45-56-355044,495596,29,
500670,500691,2022-12-28_09-46-01-572525,500694,21,
505837,505889,2022-12-28_09-46-06-902913,505894,52,
510945,510982,2022-12-28_09-46-12-115330,510986,37,
516057,516087,2022-12-28_09-46-17-334948,516090,30,
521164,521200,2022-12-28_09-46-22-564851,521205,36,
526274,526309,2022-12-28_09-46-27-792980,526314,35,
531377,531399,2022-12-28_09-46-33-008286,531402,22,
536484,536516,2022-12-28_09-46-38-242398,536521,32,
541639,541715,2022-12-28_09-46-43-561988,541721,76,
546746,546813,2022-12-28_09-46-48-779768,546819,67,
551854,551876,2022-12-28_09-46-53-967050,551878,22,
556998,557028,2022-12-28_09-46-59-235068,557033,30,
562101,562121,2022-12-28_09-47-04-461458,562124,20,
567261,567313,2022-12-28_09-47-09-767575,567315,52,
572358,572382,2022-12-28_09-47-14-965237,572385,24,
577508,577529,2022-12-28_09-47-20-234241,577532,21,
582617,582636,2022-12-28_09-47-25-459662,582640,19,
587731,587809,2022-12-28_09-47-30-759376,587812,78,
592839,592918,2022-12-28_09-47-35-979715,592920,79,
597940,597962,2022-12-28_09-47-41-145863,597964,22,
603048,603071,2022-12-28_09-47-46-381353,603075,23,
608198,608237,2022-12-28_09-47-51-658031,608240,39,
613305,613335,2022-12-28_09-47-56-880397,613338,30,
618404,618423,2022-12-28_09-48-02-089418,618428,19,
623534,623553,2022-12-28_09-48-07-344157,623556,19,
628649,628669,2022-12-28_09-48-12-575619,628673,20,
633761,633784,2022-12-28_09-48-17-811767,633787,23,
638889,638909,2022-12-28_09-48-23-062056,638912,20,
644017,644039,2022-12-28_09-48-28-312611,644042,22,
649154,649230,2022-12-28_09-48-33-623399,649233,76,
654254,654274,2022-12-28_09-48-38-789117,654277,20,
659379,659458,2022-12-28_09-48-44-090508,659463,79,
664504,664562,2022-12-28_09-48-49-311983,664568,58,
669641,669663,2022-12-28_09-48-54-534446,669666,22,
674775,674864,2022-12-28_09-48-59-857616,674869,89,
679896,679970,2022-12-28_09-49-05-084764,679974,74,
685177,685262,2022-12-28_09-49-10-502843,685268,85,
690275,690297,2022-12-28_09-49-15-656886,690300,22,
695393,695463,2022-12-28_09-49-20-946264,695466,70,
700491,700578,2022-12-28_09-49-26-173998,700583,87,
705608,705661,2022-12-28_09-49-31-388033,705665,53,
710739,710761,2022-12-28_09-49-36-608475,710763,22,
715875,715894,2022-12-28_09-49-41-864426,715898,19,
721022,721069,2022-12-28_09-49-47-165901,721072,47,
726121,726171,2022-12-28_09-49-52-384895,726174,50,
731248,731279,2022-12-28_09-49-57-606844,731281,31,
736365,736386,2022-12-28_09-50-02-843312,736389,21,
741488,741509,2022-12-28_09-50-08-081247,741512,21,
746604,746624,2022-12-28_09-50-13-319018,746627,20,
751722,751807,2022-12-28_09-50-18-617781,751810,85,
756831,756887,2022-12-28_09-50-23-817339,756889,56,
761956,761996,2022-12-28_09-50-29-049634,761999,40,
767086,767106,2022-12-28_09-50-34-280369,767110,20,
772223,772300,2022-12-28_09-50-39-598383,772305,77,
777352,777396,2022-12-28_09-50-44-813153,777399,44,
782483,782506,2022-12-28_09-50-50-044884,782511,23,
787631,787712,2022-12-28_09-50-55-366680,787719,81,
792743,792801,2022-12-28_09-51-00-588034,792806,58,
797867,797899,2022-12-28_09-51-05-802362,797902,32,
802976,803021,2022-12-28_09-51-11-033130,803027,45,
808073,808098,2022-12-28_09-51-16-243575,808100,25,
813212,813233,2022-12-28_09-51-21-497923,813236,21,
818324,818344,2022-12-28_09-51-26-726768,818347,20,
823440,823506,2022-12-28_09-51-32-018246,823508,66,
828549,828615,2022-12-28_09-51-37-246670,828618,66,
833648,833670,2022-12-28_09-51-42-418535,833673,22,
838793,838831,2022-12-28_09-51-47-692157,838833,38,
843900,843922,2022-12-28_09-51-52-915524,843925,22,
849042,849063,2022-12-28_09-51-58-173293,849066,21,
854188,854237,2022-12-28_09-52-03-463114,854240,49,
859295,859339,2022-12-28_09-52-08-685600,859344,44,
864432,864456,2022-12-28_09-52-13-929699,864459,24,
869534,869556,2022-12-28_09-52-19-154110,869559,22,
874660,874680,2022-12-28_09-52-24-399565,874684,20,
879767,879787,2022-12-28_09-52-29-625333,879790,20,
884915,884937,2022-12-28_09-52-34-895539,884940,22,
890069,890143,2022-12-28_09-52-40-225881,890148,74,
895178,895243,2022-12-28_09-52-45-447927,895246,65,
900283,900357,2022-12-28_09-52-50-670113,900362,74,
905393,905446,2022-12-28_09-52-55-888117,905450,53,
910501,910559,2022-12-28_09-53-01-114661,910565,58,
915601,915621,2022-12-28_09-53-06-300020,915626,20,
920749,920779,2022-12-28_09-53-11-570144,920784,30,
925855,925948,2022-12-28_09-53-16-874238,925951,93,
930962,930982,2022-12-28_09-53-22-031416,930985,20,
936080,936157,2022-12-28_09-53-27-319375,936160,77,
941178,941199,2022-12-28_09-53-32-491479,941202,21,
946287,946307,2022-12-28_09-53-37-713052,946311,20,
951440,951474,2022-12-28_09-53-42-991453,951476,34,
956548,956574,2022-12-28_09-53-48-225758,956577,26,
961676,961697,2022-12-28_09-53-53-465289,961699,21,
966788,966813,2022-12-28_09-53-58-701377,966816,25,
971897,971919,2022-12-28_09-54-03-928136,971922,22,
977011,977075,2022-12-28_09-54-09-207510,977081,64,
982111,982131,2022-12-28_09-54-14-384024,982135,20,
987264,987298,2022-12-28_09-54-19-660424,987303,34,
992368,992482,2022-12-28_09-54-24-977299,997498,114,
997511,997530,2022-12-28_09-54-30-147426,997533,19,
1002619,1002679,2022-12-28_09-54-35-427983,1002683,60,
1007725,1007784,2022-12-28_09-54-40-650609,1007787,59,
1012834,1012897,2022-12-28_09-54-45-867290,1012902,63,
1017942,1017992,2022-12-28_09-54-51-094565,1017997,50,
1023050,1023101,2022-12-28_09-54-56-324669,1023104,51,
1028159,1028189,2022-12-28_09-55-01-529841,1028193,30,
1033303,1033399,2022-12-28_09-55-06-854936,1033402,96,
1038420,1038491,2022-12-28_09-55-12-077109,1038494,71,
1043550,1043569,2022-12-28_09-55-17-277352,1043573,19,
1048672,1048695,2022-12-28_09-55-22-523826,1048698,23,
1053803,1053826,2022-12-28_09-55-27-769869,1053829,23,
1058913,1058947,2022-12-28_09-55-33-018378,1058950,34,
1064041,1064109,2022-12-28_09-55-38-299860,1064114,68,
1069154,1069175,2022-12-28_09-55-43-489622,1069177,21,
1074270,1074313,2022-12-28_09-55-48-744886,1074315,43,
1079378,1079408,2022-12-28_09-55-53-958502,1079410,30,
1084486,1084509,2022-12-28_09-55-59-189136,1084511,23,
1089630,1089651,2022-12-28_09-56-04-448972,1089654,21,
1094754,1094828,2022-12-28_09-56-09-742068,1094833,74,
1099891,1099912,2022-12-28_09-56-14-959204,1099914,21,
1105011,1105038,2022-12-28_09-56-20-193267,1105043,27,
1110113,1110134,2022-12-28_09-56-25-414668,1110137,21,
1115247,1115317,2022-12-28_09-56-30-720499,1115320,70,
1120374,1120434,2022-12-28_09-56-35-953913,1120439,60,
1125509,1125530,2022-12-28_09-56-41-174895,1125533,21,
1130651,1130672,2022-12-28_09-56-46-438497,1130675,21,
1135785,1135834,2022-12-28_09-56-51-722328,1135836,49,
1140916,1140937,2022-12-28_09-56-56-938918,1140940,21,
1146026,1146143,2022-12-28_09-57-02-265733,1151156,117,
1151178,1151243,2022-12-28_09-57-07-493558,1151249,65,
1156305,1156340,2022-12-28_09-57-12-707030,1156343,35,
1161433,1161453,2022-12-28_09-57-17-940603,1161456,20,
1166568,1166643,2022-12-28_09-57-23-253092,1166646,75,
1171677,1171697,2022-12-28_09-57-28-433710,1171700,20,
1176798,1176819,2022-12-28_09-57-33-672446,1176822,21,
1181945,1182037,2022-12-28_09-57-39-023192,1182040,92,
1187116,1187143,2022-12-28_09-57-44-246002,1187145,27,
1192223,1192253,2022-12-28_09-57-49-476430,1192259,30,
1197353,1197373,2022-12-28_09-57-54-725143,1197376,20,
1202485,1202556,2022-12-28_09-58-00-023285,1202561,71,
1207611,1207723,2022-12-28_09-58-05-312251,1212739,112,
1212758,1212783,2022-12-28_09-58-10-483747,1212786,25,
1217853,1217873,2022-12-28_09-58-15-701987,1217875,20,
1222958,1222980,2022-12-28_09-58-20-923970,1222982,22,
1228066,1233175,2022-12-28_09-58-26-152392,1233183,5109,
1233196,1233227,2022-12-28_09-58-31-415379,1233230,31,
1238285,1238307,2022-12-28_09-58-36-612110,1238310,22,
1243423,1243443,2022-12-28_09-58-41-865295,1243445,20,
1248540,1248580,2022-12-28_09-58-47-125383,1248583,40,
1253648,1253695,2022-12-28_09-58-52-352366,1253701,47,
1258747,1258783,2022-12-28_09-58-57-574414,1258786,36,
1263859,1263891,2022-12-28_09-59-02-810391,1263895,32,
1268969,1274071,2022-12-28_09-59-08-117382,1274086,5102,
1274099,1274119,2022-12-28_09-59-13-269637,1274122,20,
1279188,1279291,2022-12-28_09-59-18-562006,1279296,103,
1284308,1284382,2022-12-28_09-59-23-777973,1284385,74,
1289408,1289428,2022-12-28_09-59-28-939461,1289432,20,
1294565,1294589,2022-12-28_09-59-34-226723,1294592,24,
1299672,1299694,2022-12-28_09-59-39-447130,1299697,22,
1304812,1304892,2022-12-28_09-59-44-772355,1304895,80,
1309918,1309997,2022-12-28_09-59-49-993597,1309999,79,
1315019,1315040,2022-12-28_09-59-55-155286,1315043,21,
1320173,1320213,2022-12-28_10-00-00-448361,1320218,40,
1325281,1325321,2022-12-28_10-00-05-669294,1325325,40,
1330389,1330410,2022-12-28_10-00-10-885756,1330412,21,
1335517,1340639,2022-12-28_10-00-16-315946,1340644,5122,
1340645,1340712,2022-12-28_10-00-21-431304,1340715,67,
1345752,1345826,2022-12-28_10-00-26-662923,1345831,74,
1350852,1350890,2022-12-28_10-00-31-846724,1350893,38,
1355968,1356055,2022-12-28_10-00-37-118437,1356062,87,
1361103,1361128,2022-12-28_10-00-42-325235,1361131,25,
1366242,1366263,2022-12-28_10-00-47-578348,1366266,21,
1371358,0,,1376460,-1371358,
1376481,1376536,2022-12-28_10-00-58-101431,1376539,55,
1381574,1381626,2022-12-28_10-01-03-307203,1381629,52,
1386683,1386743,2022-12-28_10-01-08-549187,1386749,60,
1391815,1391835,2022-12-28_10-01-13-769812,1391837,20,
1396928,1396952,2022-12-28_10-01-18-995865,1396957,24,
1402073,1402130,2022-12-28_10-01-24-305781,1402133,57,
1407172,1407204,2022-12-28_10-01-29-495466,1407207,32,
1412325,1412345,2022-12-28_10-01-34-761352,1412348,20,
1417428,1417449,2022-12-28_10-01-39-987375,1417451,21,
1422559,1422580,2022-12-28_10-01-45-234202,1422583,21,
1427726,1427773,2022-12-28_10-01-50-537986,1427778,47,
1432833,1432872,2022-12-28_10-01-55-757500,1432878,39,
1437937,1437959,2022-12-28_10-02-00-975199,1437962,22,
1443105,1443176,2022-12-28_10-02-06-307158,1443181,71,
1448242,1448266,2022-12-28_10-02-11-522899,1448269,24,
1453370,1453389,2022-12-28_10-02-16-769484,1453392,19,
1458495,1458564,2022-12-28_10-02-22-068299,1458568,69,
1463598,1463620,2022-12-28_10-02-27-231143,1463622,22,
1468721,1468785,2022-12-28_10-02-32-515464,1468788,64,
1473841,1473896,2022-12-28_10-02-37-752836,1473899,55,
1478964,1478991,2022-12-28_10-02-42-959654,1478996,27,
1484077,1484097,2022-12-28_10-02-48-190418,1484100,20,
1489196,1489216,2022-12-28_10-02-53-426537,1489219,20,
1494312,1494383,2022-12-28_10-02-58-719522,1494387,71,
1499452,1499499,2022-12-28_10-03-03-957534,1499504,47,
1504585,1504605,2022-12-28_10-03-09-185918,1504608,20,
1509701,1509790,2022-12-28_10-03-14-488595,1509793,89,
1514828,1514849,2022-12-28_10-03-19-676853,1514852,21,
1519939,1519961,2022-12-28_10-03-24-906757,1519964,22,
1525068,1525088,2022-12-28_10-03-30-157899,1525091,20,
1530202,1530224,2022-12-28_10-03-35-413248,1530226,22,
1535326,1535419,2022-12-28_10-03-40-717554,1535425,93,
1540448,1540512,2022-12-28_10-03-45-941016,1540517,64,
1545581,1545602,2022-12-28_10-03-51-160570,1545605,21,
1550699,1550719,2022-12-28_10-03-56-392655,1550722,20,
1555808,1555905,2022-12-28_10-04-01-697557,1555908,97,
1560936,1560999,2022-12-28_10-04-06-918502,1561002,63,
1566033,1566053,2022-12-28_10-04-12-091320,1566056,20,
1571154,1571230,2022-12-28_10-04-17-374532,1571235,76,
1576289,1576316,2022-12-28_10-04-22-594436,1576319,27,
1581442,1581518,2022-12-28_10-04-27-921216,1581523,76,
1586563,1586629,2022-12-28_10-04-33-147657,1586634,66,
1591695,1591726,2022-12-28_10-04-38-360694,1591731,31,
1596814,1596836,2022-12-28_10-04-43-596233,1596838,22,
1601945,1601964,2022-12-28_10-04-48-845659,1601968,19,
1607065,1607139,2022-12-28_10-04-54-135697,1607142,74,
1612173,1612193,2022-12-28_10-04-59-311645,1612196,20,
1617300,1617335,2022-12-28_10-05-04-571794,1617338,35,
1622436,1622473,2022-12-28_10-05-09-826098,1622476,37,
1627564,1627649,2022-12-28_10-05-15-129488,1627655,85,
1632686,1632758,2022-12-28_10-05-20-351313,1632763,72,
1637791,1637813,2022-12-28_10-05-25-530171,1637816,22,
1642899,1642923,2022-12-28_10-05-30-761205,1642926,24,
1648029,1648066,2022-12-28_10-05-36-023044,1648071,37,
1653153,1653175,2022-12-28_10-05-41-251236,1653177,22,
1658267,1658358,2022-12-28_10-05-46-560463,1658364,91,
1663367,1663391,2022-12-28_10-05-51-711460,1663395,24,
1668482,1668558,2022-12-28_10-05-57-000249,1668561,76,
1673623,1673665,2022-12-28_10-06-02-239910,1673669,42,
1678751,1678772,2022-12-28_10-06-07-459253,1678775,21,
1683858,1683892,2022-12-28_10-06-12-686830,1683898,34,
1688996,1689018,2022-12-28_10-06-17-951097,1689020,22,
1694113,1694174,2022-12-28_10-06-23-223591,1694179,61,
1699219,1699275,2022-12-28_10-06-28-446112,1699278,56,
1704361,1704453,2022-12-28_10-06-33-761344,1704456,92,
1709493,1709574,2022-12-28_10-06-38-995032,1709579,81,
1714590,1714668,2022-12-28_10-06-44-212365,1714673,78,
1719708,1719786,2022-12-28_10-06-49-443971,1719791,78,
1724815,1724885,2022-12-28_10-06-54-663838,1724890,70,
1729923,1729987,2022-12-28_10-06-59-884915,1729992,64,
1735032,1735086,2022-12-28_10-07-05-108574,1735088,54,
1740140,1740174,2022-12-28_10-07-10-314767,1740177,34,
1745247,1745281,2022-12-28_10-07-15-542509,1745284,34,
1750386,1750409,2022-12-28_10-07-20-800076,1750412,23,
1755494,1755514,2022-12-28_10-07-26-020728,1755517,20,
1760631,1765760,2022-12-28_10-07-31-335601,1765773,5129,
1765786,1765805,2022-12-28_10-07-36-555187,1765808,19,
1770864,1770885,2022-12-28_10-07-41-757851,1770887,21,
1775985,1776003,2022-12-28_10-07-46-998486,1776006,18,
1781093,1781188,2022-12-28_10-07-52-306572,1781191,95,
1786209,1786229,2022-12-28_10-07-57-463852,1786232,20,
1791316,1791402,2022-12-28_10-08-02-754857,1791405,86,
1796423,1796507,2022-12-28_10-08-07-976559,1796510,84,
1801538,1801606,2022-12-28_10-08-13-199381,1801611,68,
1806650,1806727,2022-12-28_10-08-18-426792,1806732,77,
1811755,1811832,2022-12-28_10-08-23-656802,1811837,77,
1816865,1816927,2022-12-28_10-08-28-870005,1816930,62,
1821969,1822034,2022-12-28_10-08-34-089161,1822039,65,
1827081,1827137,2022-12-28_10-08-39-319543,1827142,56,
1832188,1832232,2022-12-28_10-08-44-542473,1832237,44,
1837297,1837358,2022-12-28_10-08-49-785610,1837361,61,
1842405,1842434,2022-12-28_10-08-54-983315,1842439,29,
1847539,1847559,2022-12-28_10-09-00-233587,1847562,20,
1852648,1852740,2022-12-28_10-09-05-520303,1852744,92,
1857754,1857777,2022-12-28_10-09-10-686255,1857780,23,
1862861,1862882,2022-12-28_10-09-15-906657,1862885,21,
1867990,1868054,2022-12-28_10-09-21-197830,1868056,64,
1873098,1873149,2022-12-28_10-09-26-416277,1873152,51,
1878227,1878252,2022-12-28_10-09-31-644805,1878255,25,
1883355,1883375,2022-12-28_10-09-36-884801,1883379,20,
1888488,1888542,2022-12-28_10-09-42-182553,1888546,54,
1893629,1893650,2022-12-28_10-09-47-411564,1893653,21,
1898789,1898859,2022-12-28_10-09-52-737418,1898864,70,
1903931,1903951,2022-12-28_10-09-57-963203,1903954,20,
1909056,1909075,2022-12-28_10-10-03-204505,1909078,19,
1914171,1914254,2022-12-28_10-10-08-503243,1914260,83,
1919292,1919316,2022-12-28_10-10-13-686356,1919319,24,
1924422,1924480,2022-12-28_10-10-18-961970,1924485,58,
1929551,1929583,2022-12-28_10-10-24-187781,1929588,32,
1934675,1934697,2022-12-28_10-10-29-436964,1934700,22,
1939793,1939866,2022-12-28_10-10-34-723472,1939872,73,
1944927,1944970,2022-12-28_10-10-39-949151,1944975,43,
1950027,1950046,2022-12-28_10-10-45-155195,1950050,19,
1955153,1955180,2022-12-28_10-10-50-407072,1955182,27,
1960309,1960355,2022-12-28_10-10-55-705932,1960358,46,
1965449,1965489,2022-12-28_10-11-00-961863,1965493,40,
1970571,1970592,2022-12-28_10-11-06-186983,1970595,21,
1975689,1975710,2022-12-28_10-11-11-426172,1975712,21,
1980808,1980898,2022-12-28_10-11-16-718738,1980903,90,
1985937,1985978,2022-12-28_10-11-21-927419,1985983,41,
1991068,1991089,2022-12-28_10-11-27-157892,1991092,21,
1996196,1996219,2022-12-28_10-11-32-412868,1996222,23,
2001303,2001329,2022-12-28_10-11-37-637361,2001332,26,
2006450,2006508,2022-12-28_10-11-42-930376,2006513,58,
2011572,2011595,2022-12-28_10-11-48-142664,2011598,23,
2016707,2016795,2022-12-28_10-11-53-471356,2016798,88,
2021814,2021883,2022-12-28_10-11-58-682342,2021887,69,
2026925,2026947,2022-12-28_10-12-03-860833,2026951,22,
2032065,2032090,2022-12-28_10-12-09-120028,2032092,25,
2037197,2037228,2022-12-28_10-12-14-370467,2037233,31,
2042318,2042339,2022-12-28_10-12-19-601352,2042341,21,
2047435,2047517,2022-12-28_10-12-24-906167,2047522,82,
2052542,2052565,2022-12-28_10-12-30-072080,2052568,23,
2057655,2057721,2022-12-28_10-12-35-346636,2057724,66,
2062756,2062777,2022-12-28_10-12-40-526139,2062779,21,
2067873,2067928,2022-12-28_10-12-45-795754,2067934,55,
2072981,2073042,2022-12-28_10-12-51-024200,2073047,61,
2078088,2078123,2022-12-28_10-12-56-233283,2078126,35,
2083197,2083232,2022-12-28_10-13-01-465206,2083238,35,
2088305,2088334,2022-12-28_10-13-06-679822,2088338,29,
2093404,2093517,2022-12-28_10-13-12-001209,2098512,113,
2098524,2098546,2022-12-28_10-13-17-141710,2098549,22,
2103629,2103654,2022-12-28_10-13-22-370289,2103657,25,
2108753,2108841,2022-12-28_10-13-27-676864,2108846,88,
2113874,2113936,2022-12-28_10-13-32-903260,2113938,62,
2118981,2119048,2022-12-28_10-13-38-132011,2119050,67,
2124089,2124146,2022-12-28_10-13-43-345080,2124151,57,
2129223,2129242,2022-12-28_10-13-48-577325,2129245,19,
2134376,2134426,2022-12-28_10-13-53-882680,2134429,50,
2139486,2139532,2022-12-28_10-13-59-110646,2139535,46,
2144594,2144653,2022-12-28_10-14-04-333300,2144659,59,
2149702,2149735,2022-12-28_10-14-09-553114,2149738,33,
2154810,2154836,2022-12-28_10-14-14-772603,2154838,26,
2159918,2159944,2022-12-28_10-14-20-001169,2159946,26,
2165025,2165048,2022-12-28_10-14-25-225697,2165050,23,
2170132,2170153,2022-12-28_10-14-30-448303,2170156,21,
2175271,2175292,2022-12-28_10-14-35-712032,2175295,21,
2180387,2180450,2022-12-28_10-14-40-987993,2180453,63,
2185494,2185564,2022-12-28_10-14-46-215393,2185569,70,
2190595,2190615,2022-12-28_10-14-51-387109,2190618,20,
2195711,2195770,2022-12-28_10-14-56-665334,2195775,59,
2200819,2200885,2022-12-28_10-15-01-882816,2200890,66,
2205927,2205983,2022-12-28_10-15-07-120319,2205987,56,
2211036,2211088,2022-12-28_10-15-12-336918,2211093,52,
2216144,2216171,2022-12-28_10-15-17-540794,2216174,27,
2221252,2221282,2022-12-28_10-15-22-772290,2221286,30,
2226360,2226384,2022-12-28_10-15-27-994189,2226386,24,
2231465,2231487,2022-12-28_10-15-33-213938,2231490,22,
2236597,2236615,2022-12-28_10-15-38-471252,2236618,18,
2241705,2241725,2022-12-28_10-15-43-696668,2241729,20,
2246856,2246895,2022-12-28_10-15-48-984046,2246897,39,
2251964,2252004,2022-12-28_10-15-54-222089,2252007,40,
2257072,2257098,2022-12-28_10-15-59-431039,2257101,26,
2262212,2262232,2022-12-28_10-16-04-692311,2262235,20,
2267325,2267398,2022-12-28_10-16-09-982222,2267401,73,
2272433,2272455,2022-12-28_10-16-15-160316,2272458,22,
2277550,2277592,2022-12-28_10-16-20-420178,2277595,42,
2282675,2282713,2022-12-28_10-16-25-659298,2282718,38,
2287793,2287825,2022-12-28_10-16-30-885478,2287830,32,
2292904,2292996,2022-12-28_10-16-36-188758,2292999,92,
2298028,2298115,2022-12-28_10-16-41-425033,2298120,87,
2303154,2303220,2022-12-28_10-16-46-645933,2303225,66,
2308294,2308315,2022-12-28_10-16-51-869598,2308318,21,
2313434,2313537,2022-12-28_10-16-57-199602,2313542,103,
2318569,2318625,2022-12-28_10-17-02-415287,2318630,56,
2323688,2323709,2022-12-28_10-17-07-622613,2323712,21,
2328806,2328827,2022-12-28_10-17-12-862155,2328830,21,
2333923,2333945,2022-12-28_10-17-18-098689,2333948,22,
2339032,2339053,2022-12-28_10-17-23-327902,2339057,21,
2344140,2344166,2022-12-28_10-17-28-553914,2344170,26,
2349258,2349335,2022-12-28_10-17-33-851214,2349340,77,
2354379,2354438,2022-12-28_10-17-39-071934,2354444,59,
2359519,2359538,2022-12-28_10-17-44-288597,2359541,19,
2364641,2364662,2022-12-28_10-17-49-540634,2364664,21,
2369797,2369829,2022-12-28_10-17-54-829005,2369831,32,
2374904,2374930,2022-12-28_10-18-00-052747,2374933,26,
2380040,2380129,2022-12-28_10-18-05-379954,2380132,89,
2385141,2385161,2022-12-28_10-18-10-527656,2385165,20,
2390305,2390345,2022-12-28_10-18-15-834660,2390351,40,
2395438,2400567,2022-12-28_10-18-21-075538,2400582,5129,
2400605,2400662,2022-12-28_10-18-26-394506,2400665,57,
2405722,2405760,2022-12-28_10-18-31-611750,2405763,38,
2410858,2410934,2022-12-28_10-18-36-918259,2410937,76,
2415979,2416059,2022-12-28_10-18-42-153242,2416064,80,
2421097,2421152,2022-12-28_10-18-47-366681,2421155,55,
2426222,2426270,2022-12-28_10-18-52-605951,2426276,48,
2431348,2431368,2022-12-28_10-18-57-824144,2431371,20,
2436508,2436552,2022-12-28_10-19-03-133980,2436555,44,
2441607,2441646,2022-12-28_10-19-08-346011,2441649,39,
2446728,2446750,2022-12-28_10-19-13-570280,2446753,22,
2451857,2451878,2022-12-28_10-19-18-820108,2451881,21,
2456978,2456998,2022-12-28_10-19-24-058714,2457001,20,
2462098,2462170,2022-12-28_10-19-29-359029,2462173,72,
2467220,2467283,2022-12-28_10-19-34-589711,2467286,63,
2472364,2472385,2022-12-28_10-19-39-808506,2472388,21,
2477470,2477501,2022-12-28_10-19-45-037507,2477507,31,
2482614,2482674,2022-12-28_10-19-50-342614,2482677,60,
2487746,2487782,2022-12-28_10-19-55-566650,2487785,36,
2492853,2492883,2022-12-28_10-20-00-788354,2492885,30,
2497966,2497997,2022-12-28_10-20-06-026204,2498000,31,
2503072,2503093,2022-12-28_10-20-11-243599,2503096,21,
2508224,2508288,2022-12-28_10-20-16-566356,2508291,64,
2513322,2513343,2022-12-28_10-20-21-738501,2513346,21,
2518471,2518493,2022-12-28_10-20-27-003445,2518496,22,
2523575,2523692,2022-12-28_10-20-32-332084,2528711,117,
2528733,2528795,2022-12-28_10-20-37-558412,2528797,62,
2533824,2533896,2022-12-28_10-20-42-781966,2533902,72,
2538933,2538997,2022-12-28_10-20-48-003995,2539002,64,
2544061,2544107,2022-12-28_10-20-53-225160,2544112,46,
2549168,2549211,2022-12-28_10-20-58-452250,2549216,43,
2554276,2554310,2022-12-28_10-21-03-671124,2554315,34,
2559382,2559409,2022-12-28_10-21-08-887768,2559412,27,
2564521,2564541,2022-12-28_10-21-14-144762,2564544,20,
2569637,2569704,2022-12-28_10-21-19-431438,2569708,67,
2574745,2574831,2022-12-28_10-21-24-671849,2574836,86,
2579845,2579867,2022-12-28_10-21-29-835981,2579870,22,
2584961,2585031,2022-12-28_10-21-35-103950,2585036,70,
2590070,2590118,2022-12-28_10-21-40-326400,2590122,48,
2595262,2595329,2022-12-28_10-21-45-655946,2595334,67,
2600409,2600429,2022-12-28_10-21-50-881245,2600431,20,
2605548,2605571,2022-12-28_10-21-56-141019,2605574,23,
2610655,2610731,2022-12-28_10-22-01-421407,2610736,76,
2615772,2615844,2022-12-28_10-22-06-643819,2615850,72,
2620880,2620960,2022-12-28_10-22-11-887970,2620964,80,
2625988,2626070,2022-12-28_10-22-17-117363,2626072,82,
2631097,2631170,2022-12-28_10-22-22-323914,2631176,73,
2636198,2636247,2022-12-28_10-22-27-533256,2636250,49,
2641313,2641367,2022-12-28_10-22-32-755889,2641373,54,
2646420,2646461,2022-12-28_10-22-37-982448,2646466,41,
2651535,2651559,2022-12-28_10-22-43-204789,2651565,24,
2656643,2656664,2022-12-28_10-22-48-427780,2656667,21,
2661781,2661876,2022-12-28_10-22-53-756417,2661881,95,
2666899,2666953,2022-12-28_10-22-58-966252,2666957,54,
2671999,2672064,2022-12-28_10-23-04-192768,2672066,65,
2677114,2677179,2022-12-28_10-23-09-416210,2677184,65,
2682224,2682266,2022-12-28_10-23-14-638038,2682272,42,
2687358,2687379,2022-12-28_10-23-19-876202,2687381,21,
2692530,2692562,2022-12-28_10-23-25-181637,2692565,32,
2697678,2697761,2022-12-28_10-23-30-506583,2697764,83,
2702800,2702874,2022-12-28_10-23-35-737584,2702879,74,
2707932,2707964,2022-12-28_10-23-40-951212,2707967,32,
2713064,2713089,2022-12-28_10-23-46-201015,2713091,25,
2718173,2718195,2022-12-28_10-23-51-428968,2718198,22,
2723281,2723373,2022-12-28_10-23-56-724926,2723376,92,
2728402,2728492,2022-12-28_10-24-01-955179,2728497,90,
2733526,2733580,2022-12-28_10-24-07-174156,2733583,54,
2738665,2738685,2022-12-28_10-24-12-399325,2738688,20,
2743802,2743883,2022-12-28_10-24-17-721213,2743886,81,
2748929,2748993,2022-12-28_10-24-22-944840,2748996,64,
2754070,2754117,2022-12-28_10-24-28-196735,2754120,47,
2759178,2759203,2022-12-28_10-24-33-401178,2759206,25,
2764307,2764331,2022-12-28_10-24-38-650032,2764334,24,
2769436,2769502,2022-12-28_10-24-43-935399,2769508,66,
2774581,2774600,2022-12-28_10-24-49-161582,2774603,19,
2779703,2779722,2022-12-28_10-24-54-401781,2779725,19,
2784818,2784838,2022-12-28_10-24-59-638870,2784841,20,
2789937,2790015,2022-12-28_10-25-04-929110,2790020,78,
2795035,2795055,2022-12-28_10-25-10-100282,2795058,20,
2800153,2800204,2022-12-28_10-25-15-365185,2800207,51,
2805269,2805290,2022-12-28_10-25-20-562236,2805294,21,
2810396,2810419,2022-12-28_10-25-25-813900,2810422,23,
2815530,2820653,2022-12-28_10-25-31-244776,2820656,5123,
2820656,2820679,2022-12-28_10-25-36-315304,2820682,23,
2825766,2825786,2022-12-28_10-25-41-544633,2825789,20,
2830887,2830908,2022-12-28_10-25-46-785471,2830910,21,
2836023,2836049,2022-12-28_10-25-52-038321,2836054,26,
2841148,2841168,2022-12-28_10-25-57-289461,2841172,20,
2846274,2846346,2022-12-28_10-26-02-583791,2846352,72,
2851399,2851432,2022-12-28_10-26-07-796059,2851435,33,
2856539,2856642,2022-12-28_10-26-13-123729,2861644,103,
2861662,2861745,2022-12-28_10-26-18-341924,2861748,83,
2866778,2866842,2022-12-28_10-26-23-564265,2866845,64,
2871913,2871945,2022-12-28_10-26-28-786971,2871948,32,
2877045,2877065,2022-12-28_10-26-34-031179,2877068,20,
2882152,2882258,2022-12-28_10-26-39-340934,2887298,106,
2887321,2887360,2022-12-28_10-26-44-570889,2887363,39,
2892439,2892462,2022-12-28_10-26-49-794100,2892465,23,
2897555,2897575,2022-12-28_10-26-55-026256,2897578,20,
2902701,2902722,2022-12-28_10-27-00-302006,2902726,21,
2907837,2907857,2022-12-28_10-27-05-555735,2907860,20,
2912944,2912965,2022-12-28_10-27-10-784578,2912968,21,
2918082,2918149,2022-12-28_10-27-16-095816,2918153,67,
2923184,2923261,2022-12-28_10-27-21-322998,2923263,77,
2928290,2928311,2022-12-28_10-27-26-495943,2928314,21,
2933410,2933461,2022-12-28_10-27-31-771395,2933466,51,
2938521,2938562,2022-12-28_10-27-36-993573,2938565,41,
2943620,2943640,2022-12-28_10-27-42-190905,2943643,20,
2948779,2948852,2022-12-28_10-27-47-532444,2948855,73,
2953876,2953897,2022-12-28_10-27-52-688752,2953901,21,
2958993,2959014,2022-12-28_10-27-57-930989,2959017,21,
2964109,2964169,2022-12-28_10-28-03-209728,2964174,60,
2969234,2969270,2022-12-28_10-28-08-430788,2969273,36,
2974342,2974389,2022-12-28_10-28-13-670531,2974392,47,
2979449,2979472,2022-12-28_10-28-18-875098,2979475,23,
2984585,2984608,2022-12-28_10-28-24-131869,2984611,23,
2989699,2989777,2022-12-28_10-28-29-420684,2989780,78,
2994800,2994884,2022-12-28_10-28-34-649911,2994889,84,
2999908,2999985,2022-12-28_10-28-39-865456,2999990,77,
3005025,3005084,2022-12-28_10-28-45-087494,3005090,59,
3010134,3010193,2022-12-28_10-28-50-313382,3010199,59,
3015240,3015284,2022-12-28_10-28-55-532353,3015289,44,
3020350,3020403,2022-12-28_10-29-00-774299,3020406,53,
3025457,3025499,2022-12-28_10-29-05-982028,3025505,42,
3030566,3030613,2022-12-28_10-29-11-216203,3030619,47,
3035675,3035705,2022-12-28_10-29-16-437325,3035708,30,
3040778,3045917,2022-12-28_10-29-21-747048,3045932,5139,
3045954,3046006,2022-12-28_10-29-26-976156,3046012,52,
3051022,3051046,2022-12-28_10-29-32-136778,3051049,24,
3056129,3056183,2022-12-28_10-29-37-402014,3056186,54,
3061238,3061318,2022-12-28_10-29-42-636740,3061323,80,
3066355,3066402,2022-12-28_10-29-47-854781,3066406,47,
3071454,3071474,2022-12-28_10-29-53-045532,3071478,20,
3076571,3076613,2022-12-28_10-29-58-311440,3076616,42,
3081678,3081713,2022-12-28_10-30-03-525153,3081716,35,
3086811,3086835,2022-12-28_10-30-08-770705,3086838,24,
3091913,3091944,2022-12-28_10-30-13-988665,3091949,31,
3097065,3097116,2022-12-28_10-30-19-293424,3097120,51,
3102173,3102238,2022-12-28_10-30-24-533383,3102241,65,
3107319,3107339,2022-12-28_10-30-29-755746,3107342,20,
3112441,3112523,2022-12-28_10-30-35-061428,3112526,82,
3117563,3117586,2022-12-28_10-30-40-246070,3117588,23,
3122672,3122737,2022-12-28_10-30-45-511232,3122744,65,
3127807,3127845,2022-12-28_10-30-50-740908,3127848,38,
3132937,3132961,2022-12-28_10-30-55-976693,3132964,24,
3138081,3138154,2022-12-28_10-31-01-291601,3138159,73,
3143188,3143253,2022-12-28_10-31-06-506398,3143256,65,
3148314,3148361,2022-12-28_10-31-11-741396,3148364,47,
3153448,3153469,2022-12-28_10-31-16-967273,3153471,21,
3158585,3158608,2022-12-28_10-31-22-227870,3158611,23,
3163706,3163770,2022-12-28_10-31-27-505006,3163777,64,
3168830,3168866,2022-12-28_10-31-32-721993,3168872,36,
3173969,3173989,2022-12-28_10-31-37-965065,3173991,20,
3179085,3179153,2022-12-28_10-31-43-259877,3179156,68,
3184201,3184220,2022-12-28_10-31-48-437959,3184223,19,
3189313,3189333,2022-12-28_10-31-53-671250,3189336,20,
3194441,3194501,2022-12-28_10-31-58-943524,3194506,60,
3199580,3199601,2022-12-28_10-32-04-181584,3199604,21,
3204691,3204710,2022-12-28_10-32-09-405266,3204713,19,
3209808,3209893,2022-12-28_10-32-14-708455,3209899,85,
3214916,3214979,2022-12-28_10-32-19-919903,3214982,63,
3220049,3220083,2022-12-28_10-32-25-143741,3220086,34,
3225196,3225215,2022-12-28_10-32-30-401875,3225218,19,
3230310,3230336,2022-12-28_10-32-35-639657,3230338,26,
3235418,3235438,2022-12-28_10-32-40-862976,3235441,20,
3240537,3240557,2022-12-28_10-32-46-109555,3240561,20,
3245654,3245690,2022-12-28_10-32-51-357425,3245693,36,
3250790,3250810,2022-12-28_10-32-56-597837,3250812,20,
3255903,3255923,2022-12-28_10-33-01-838699,3255926,20,
3261024,3261119,2022-12-28_10-33-07-151058,3261121,95,
3266147,3266198,2022-12-28_10-33-12-358394,3266202,51,
3271284,3271304,2022-12-28_10-33-17-588737,3271307,20,
3276394,3276416,2022-12-28_10-33-22-817992,3276419,22,
3281502,3281593,2022-12-28_10-33-28-118901,3281597,91,
3286610,3286630,2022-12-28_10-33-33-281325,3286634,20,
3291728,3291795,2022-12-28_10-33-38-564548,3291798,67,
3296866,3296892,2022-12-28_10-33-43-789772,3296895,26,
3302001,3302093,2022-12-28_10-33-49-111644,3302096,92,
3307135,3307207,2022-12-28_10-33-54-347616,3307211,72,
3312260,3312318,2022-12-28_10-33-59-568445,3312324,58,
3317359,3317378,2022-12-28_10-34-04-762017,3317381,19,
3322505,3322525,2022-12-28_10-34-10-024070,3322528,20,
3327626,3327698,2022-12-28_10-34-15-325762,3327701,72,
3332728,3332805,2022-12-28_10-34-20-557030,3332810,77,
3337830,3337850,2022-12-28_10-34-25-716725,3337853,20,
3342975,3343005,2022-12-28_10-34-30-994759,3343008,30,
3348081,3348117,2022-12-28_10-34-36-227510,3348122,36,
3353190,3353211,2022-12-28_10-34-41-446918,3353214,21,
3358344,3358431,2022-12-28_10-34-46-776377,3358436,87,
3363454,3363522,2022-12-28_10-34-51-996154,3363528,68,
3368562,3368644,2022-12-28_10-34-57-229503,3368649,82,
3373660,3373684,2022-12-28_10-35-02-396922,3373688,24,
3378778,0,,3378817,-3378778,
3383901,3383934,2022-12-28_10-35-12-879959,3383936,33,
3388994,3389036,2022-12-28_10-35-18-106646,3389038,42,
3394104,3394127,2022-12-28_10-35-23-328854,3394130,23,
3399210,3399237,2022-12-28_10-35-28-558461,3399240,27,
3404335,3404359,2022-12-28_10-35-33-799416,3404361,24,
3409436,3409529,2022-12-28_10-35-39-091469,3409532,93,
3414576,3414650,2022-12-28_10-35-44-332263,3414656,74,
3419681,3419740,2022-12-28_10-35-49-540969,3419746,59,
3424793,3424860,2022-12-28_10-35-54-774839,3424866,67,
3429891,3429913,2022-12-28_10-35-59-949012,3429916,22,
3435037,3435069,2022-12-28_10-36-05-221753,3435074,32,
3440144,3440171,2022-12-28_10-36-10-444931,3440174,27,
3445262,3445355,2022-12-28_10-36-15-758592,3445360,93,
3450368,3450389,2022-12-28_10-36-20-908241,3450391,21,
3455476,3455496,2022-12-28_10-36-26-138909,3455499,20,
3460588,3460656,2022-12-28_10-36-31-425415,3460659,68,
3465708,3465770,2022-12-28_10-36-36-654690,3465772,62,
3470817,3470856,2022-12-28_10-36-41-862355,3470859,39,
3475924,3475970,2022-12-28_10-36-47-090535,3475975,46,
3481034,3481076,2022-12-28_10-36-52-319340,3481081,42,
3486132,3486175,2022-12-28_10-36-57-535021,3486178,43,
3491292,3491366,2022-12-28_10-37-02-854323,3491375,74,
3496425,3496448,2022-12-28_10-37-08-048702,3496451,23,
3501564,
3506663,3506682,2022-12-28_10-37-18-529934,3506685,19,
3511816,3511884,2022-12-28_10-37-23-847739,3511887,68,
3516938,3517006,2022-12-28_10-37-29-092947,3517009,68,
3522048,3522098,2022-12-28_10-37-34-301025,3522100,50,
3527169,3527197,2022-12-28_10-37-39-523486,3527203,28,
3532281,3532301,2022-12-28_10-37-44-752100,3532304,20,
3537405,3537426,2022-12-28_10-37-49-999949,3537429,21,
3542534,3542614,2022-12-28_10-37-55-301481,3542619,80,
3547668,3547694,2022-12-28_10-38-00-519620,3547698,26,
3552800,3552825,2022-12-28_10-38-05-768189,3552828,25,
3557921,3557994,2022-12-28_10-38-11-054111,3558002,73,
3563062,3563092,2022-12-28_10-38-16-278252,3563095,30,
3568188,3568208,2022-12-28_10-38-21-520528,3568211,20,
3573298,3573393,2022-12-28_10-38-26-823617,3573395,95,
3578430,3578517,2022-12-28_10-38-32-065396,3578522,87,
3583569,3583623,2022-12-28_10-38-37-299121,3583627,54,
3588705,3588726,2022-12-28_10-38-42-523120,3588729,21,
3593825,3593914,2022-12-28_10-38-47-831162,3593919,89,
3598940,3598966,2022-12-28_10-38-53-006751,3598969,26,
3604060,3604107,2022-12-28_10-38-58-269873,3604110,47,
3609184,3609204,2022-12-28_10-39-03-492525,3609207,20,
3614299,3614358,2022-12-28_10-39-08-754086,3614361,59,
3619410,0,,3619514,-3619410,
3624523,3624611,2022-12-28_10-39-19-252557,3624615,88,
3629629,3629651,2022-12-28_10-39-24-411674,3629653,22,
3634758,3634779,2022-12-28_10-39-29-664558,3634782,21,
3639867,3639889,2022-12-28_10-39-34-893919,3639892,22,
3644998,3645032,2022-12-28_10-39-40-152926,3645039,34,
3650121,3655242,2022-12-28_10-39-45-577193,3655245,5121,
3655245,3655270,2022-12-28_10-39-50-645234,3655272,25,
3660358,3660430,2022-12-28_10-39-55-922063,3660433,72,
3665472,3665493,2022-12-28_10-40-01-103596,3665495,21,
3670580,3670599,2022-12-28_10-40-06-331846,3670603,19,
3675715,3675744,2022-12-28_10-40-11-600640,3675747,29,
3680827,3680850,2022-12-28_10-40-16-819424,3680852,23,
3685942,3685962,2022-12-28_10-40-22-053343,3685965,20,
3691075,3691152,2022-12-28_10-40-27-358504,3691158,77,
3696207,3696252,2022-12-28_10-40-32-583393,3696257,45,
3701316,3701349,2022-12-28_10-40-37-804518,3701352,33,
3706445,3706468,2022-12-28_10-40-43-039535,3706472,23,
3711572,3711641,2022-12-28_10-40-48-337056,3711644,69,
3716695,3716769,2022-12-28_10-40-53-580214,3716775,74,
3721814,3721866,2022-12-28_10-40-58-799244,3721871,52,
3726949,3727009,2022-12-28_10-41-04-042913,3727012,60,
3732063,3732083,2022-12-28_10-41-09-258130,3732086,20,
3737172,3737265,2022-12-28_10-41-14-557548,3737268,93,
3742278,3742307,2022-12-28_10-41-19-717646,3742310,29,
3747387,3747444,2022-12-28_10-41-24-956066,3747447,57,
3752504,3752524,2022-12-28_10-41-30-184829,3752526,20,
3757660,3757683,2022-12-28_10-41-35-460724,3757686,23,
3762763,3762818,2022-12-28_10-41-40-720902,3762821,55,
3767876,3767972,2022-12-28_10-41-46-003172,3767977,96,
3772977,3773004,2022-12-28_10-41-51-149721,3773006,27,
3778106,3778127,2022-12-28_10-41-56-394686,3778130,21,
3783222,3783269,2022-12-28_10-42-01-662710,3783272,47,
3788322,3788344,2022-12-28_10-42-06-855649,3788347,22,
3793439,3793482,2022-12-28_10-42-12-112280,3793487,43,
3798546,3798569,2022-12-28_10-42-17-332944,3798572,23,
3803688,3803708,2022-12-28_10-42-22-586414,3803711,20,
3808813,3808880,2022-12-28_10-42-27-876983,3808883,67,
3813919,3814019,2022-12-28_10-42-33-121397,3814024,100,
3819028,3819089,2022-12-28_10-42-38-322365,3819093,61,
3824126,3824188,2022-12-28_10-42-43-549208,3824191,62,
3829243,3829305,2022-12-28_10-42-48-778955,3829310,62,
3834351,3834408,2022-12-28_10-42-54-004232,3834413,57,
3839459,3844563,2022-12-28_10-42-59-350125,3844568,5104,
3844568,3844609,2022-12-28_10-43-04-448188,3844614,41,
3849667,3849709,2022-12-28_10-43-09-668899,3849711,42,
3854823,3854897,2022-12-28_10-43-14-983407,3854901,74,
3859921,3859941,2022-12-28_10-43-20-141484,3859944,20,
3865076,3865100,2022-12-28_10-43-25-424758,3865103,24,
3870220,3870239,2022-12-28_10-43-30-682228,3870242,19,
3875327,3875350,2022-12-28_10-43-35-910020,3875353,23,
3880436,3880518,2022-12-28_10-43-41-201381,3880521,82,
3885550,3885632,2022-12-28_10-43-46-427574,3885638,82,
3890656,3890721,2022-12-28_10-43-51-646244,3890724,65,
3895767,3895823,2022-12-28_10-43-56-868881,3895829,56,
3900883,3900931,2022-12-28_10-44-02-098268,3900934,48,
3905990,3906030,2022-12-28_10-44-07-319175,3906035,40,
3911097,3911118,2022-12-28_10-44-12-534023,3911121,21,
3916204,3916225,2022-12-28_10-44-17-758727,3916228,21,
3921308,3921328,2022-12-28_10-44-22-988833,3921337,20,
3926449,3926547,2022-12-28_10-44-28-330319,3926550,98,
3931562,3931623,2022-12-28_10-44-33-523510,3931626,61,
3936670,3936733,2022-12-28_10-44-38-756759,3936739,63,
3941779,3941843,2022-12-28_10-44-43-978848,3941848,64,
3946886,3946925,2022-12-28_10-44-49-189789,3946928,39,
3952025,3952051,2022-12-28_10-44-54-432358,3952054,26,
3957143,3957163,2022-12-28_10-44-59-663725,3957166,20,
3962252,3962276,2022-12-28_10-45-04-897032,3962279,24,
3967376,3967398,2022-12-28_10-45-10-133123,3967402,22,
3972499,3972565,2022-12-28_10-45-15-416197,3972570,66,
3977626,3977667,2022-12-28_10-45-20-638015,3977673,41,
3982757,3982777,2022-12-28_10-45-25-879125,3982780,20,
3987886,3987968,2022-12-28_10-45-31-188925,3987973,82,
3992985,3993007,2022-12-28_10-45-36-352031,3993009,22,
3998127,3998166,2022-12-28_10-45-41-630491,3998171,39,
4003250,4003288,2022-12-28_10-45-46-872361,4003290,38,
4008391,4008485,2022-12-28_10-45-52-189049,4008490,94,
4013516,4013598,2022-12-28_10-45-57-411775,4013604,82,
4018623,4018670,2022-12-28_10-46-02-621777,4018675,47,
4023753,4023776,2022-12-28_10-46-07-849135,4023780,23,
4028883,4028905,2022-12-28_10-46-13-099512,4028908,22,
4034006,4034084,2022-12-28_10-46-18-396481,4034087,78,
4039119,4039138,2022-12-28_10-46-23-568833,4039142,19,
4044227,4044246,2022-12-28_10-46-28-797986,4044249,19,
4049362,4049386,2022-12-28_10-46-34-058670,4049388,24,
4054466,4054489,2022-12-28_10-46-39-279902,4054492,23,
4059574,4059594,2022-12-28_10-46-44-510287,4059597,20,
4064709,4064731,2022-12-28_10-46-49-759992,4064733,22,
4069833,4069912,2022-12-28_10-46-55-066052,4069915,79,
4074964,4074997,2022-12-28_10-47-00-275032,4075002,33,
4080094,4080115,2022-12-28_10-47-05-512070,4080120,21,
4085225,4085303,2022-12-28_10-47-10-824866,4085308,78,
4090332,4090402,2022-12-28_10-47-16-044648,4090405,70,
4095457,4095490,2022-12-28_10-47-21-249923,4095494,33,
4100584,4100607,2022-12-28_10-47-26-494015,4100610,23,
4105703,4105723,2022-12-28_10-47-31-729972,4105726,20,
4110829,4110858,2022-12-28_10-47-36-988355,4110862,29,
4115949,4116015,2022-12-28_10-47-42-264346,4116018,66,
4121083,4121105,2022-12-28_10-47-47-474422,4121107,22,
4126193,4126218,2022-12-28_10-47-52-704412,4126224,25,
4131310,4131343,2022-12-28_10-47-57-936065,4131348,33,
4136422,4136448,2022-12-28_10-48-03-171737,4136450,26,
4141552,4141623,2022-12-28_10-48-08-474262,4141627,71,
4146677,4146731,2022-12-28_10-48-13-696045,4146737,54,
4151815,4151847,2022-12-28_10-48-18-929968,4151853,32,
4156932,4157020,2022-12-28_10-48-24-232915,4157022,88,
4162061,4162135,2022-12-28_10-48-29-467750,4162141,74,
4167168,4167240,2022-12-28_10-48-34-691111,4167245,72,
4172278,4172335,2022-12-28_10-48-39-913357,4172340,57,
4177384,4177450,2022-12-28_10-48-45-140648,4177455,66,
4182493,4182519,2022-12-28_10-48-50-348765,4182522,26,
4187601,4187639,2022-12-28_10-48-55-581110,4187644,38,
4192708,4192739,2022-12-28_10-49-00-802359,4192742,31,
4197844,4197865,2022-12-28_10-49-06-044474,4197868,21,
4202952,4202973,2022-12-28_10-49-11-276688,4202975,21,
4208087,4208108,2022-12-28_10-49-16-536149,4208111,21,
4213204,4213259,2022-12-28_10-49-21-788396,4213264,55,
4218314,4218339,2022-12-28_10-49-27-004401,4218342,25,
4223417,
4228519,4228565,2022-12-28_10-49-37-461244,4228568,46,
4233663,4233698,2022-12-28_10-49-42-720931,4233701,35,
4238771,4238794,2022-12-28_10-49-47-940577,4238797,23,
4243907,4243957,2022-12-28_10-49-53-229761,4243960,50,
4249015,4249063,2022-12-28_10-49-58-448161,4249068,48,
4254124,4254151,2022-12-28_10-50-03-666834,4254154,27,
4259264,4259286,2022-12-28_10-50-08-919903,4259289,22,
4264380,4264403,2022-12-28_10-50-14-149403,4264406,23,
4269487,4269566,2022-12-28_10-50-19-440062,4269569,79,
4274604,4274659,2022-12-28_10-50-24-655896,4274663,55,
4279705,4279747,2022-12-28_10-50-29-856036,4279749,42,
4284822,4284874,2022-12-28_10-50-35-110301,4284877,52,
4289927,4289983,2022-12-28_10-50-40-330089,4289988,56,
4295029,4295048,2022-12-28_10-50-45-520007,4295051,19,
4300165,4300185,2022-12-28_10-50-50-783242,4300188,20,
4305335,4310459,2022-12-28_10-50-56-236825,4310464,5124,
4310465,4310488,2022-12-28_10-51-01-332017,4310491,23,
4315567,4315590,2022-12-28_10-51-06-557970,4315593,23,
4320725,4320783,2022-12-28_10-51-11-874420,4320789,58,
4325832,4325888,2022-12-28_10-51-17-096274,4325894,56,
4330940,4330994,2022-12-28_10-51-22-314768,4330999,54,
4336049,4336114,2022-12-28_10-51-27-546382,4336119,65,
4341157,4341202,2022-12-28_10-51-32-766416,4341207,45,
4346264,4346320,2022-12-28_10-51-37-989966,4346325,56,
4351371,4351405,2022-12-28_10-51-43-208769,4351410,34,
4356472,4356507,2022-12-28_10-51-48-424718,4356510,35,
4361619,4361643,2022-12-28_10-51-53-689928,4361646,24,
4366727,4371850,2022-12-28_10-51-59-080686,4371853,5123,
4371853,4371881,2022-12-28_10-52-04-174703,4371884,28,
4376975,4377026,2022-12-28_10-52-09-442076,4377029,51,
4382108,4382137,2022-12-28_10-52-14-682869,4382140,29,
4387233,4387253,2022-12-28_10-52-19-912174,4387255,20,
4392352,4397471,2022-12-28_10-52-25-302057,4397476,5119,
4397477,4397511,2022-12-28_10-52-30-408699,4397515,34,
4402590,4402623,2022-12-28_10-52-35-640618,4402627,33,
4407735,4407762,2022-12-28_10-52-40-900698,4407765,27,
4412891,4412933,2022-12-28_10-52-46-191084,4412936,42,
4418008,4418029,2022-12-28_10-52-51-410539,4418031,21,
4423130,4423159,2022-12-28_10-52-56-654791,4423161,29,
4428246,4428269,2022-12-28_10-53-01-890011,4428273,23,
4433356,4433376,2022-12-28_10-53-07-121018,4433380,20,
4438483,4438539,2022-12-28_10-53-12-402067,4438544,56,
4443617,4443639,2022-12-28_10-53-17-624514,4443642,22,
4448740,4448815,2022-12-28_10-53-22-930315,4448818,75,
4453854,4453873,2022-12-28_10-53-28-107837,4453876,19,
4458971,4459046,2022-12-28_10-53-33-397888,4459052,75,
4464109,4469209,2022-12-28_10-53-38-745655,4469214,5100,
4469214,4469242,2022-12-28_10-53-43-827899,4469245,28,
4474344,4474364,2022-12-28_10-53-49-077599,4474367,20,
4479459,4479543,2022-12-28_10-53-54-373054,4479547,84,
4484575,4484595,2022-12-28_10-53-59-551296,4484599,20,
4489701,4489770,2022-12-28_10-54-04-832580,4489776,69,
4494833,4494853,2022-12-28_10-54-10-044694,4494856,20,
4499959,4499984,2022-12-28_10-54-15-304255,4499986,25,
4505090,4510184,2022-12-28_10-54-20-699120,4510187,5094,
4510187,4510275,2022-12-28_10-54-25-820432,4510278,88,
4515302,0,,4515324,-4515302,
4520442,4520474,2022-12-28_10-54-36-270419,4520480,32,
4525560,4525654,2022-12-28_10-54-41-583210,4525657,94,
4530674,4530696,2022-12-28_10-54-46-740125,4530699,22,
4535794,4535815,2022-12-28_10-54-51-974732,4535817,21,
4540923,4540943,2022-12-28_10-54-57-225986,4540946,20,
4546040,4546077,2022-12-28_10-55-02-480829,4546083,37,
4551161,4551181,2022-12-28_10-55-07-705966,4551184,20,
4556281,4556308,2022-12-28_10-55-12-954219,4556312,27,
4561393,4561414,2022-12-28_10-55-18-178893,4561416,21,
4566500,4566520,2022-12-28_10-55-23-405482,4566524,20,
4571628,4571709,2022-12-28_10-55-28-702371,4571714,81,
4576728,4576749,2022-12-28_10-55-33-877465,4576752,21,
4581835,4581855,2022-12-28_10-55-39-103923,4581858,20,
4586975,4586994,2022-12-28_10-55-44-368892,4586997,19,
4592089,4592189,2022-12-28_10-55-49-684535,4592192,100,
4597205,4597228,2022-12-28_10-55-54-835976,4597230,23,
4602312,4602333,2022-12-28_10-56-00-059961,4602335,21,
4607456,4607504,2022-12-28_10-56-05-355072,4607507,48,
4612556,4612612,2022-12-28_10-56-10-578699,4612615,56,
4617687,4617711,2022-12-28_10-56-15-800560,4617714,24,
4622788,4622897,2022-12-28_10-56-21-106550,4627901,109,
4627913,4627935,2022-12-28_10-56-26-266264,4627937,22,
4633029,4633107,2022-12-28_10-56-31-563315,4633110,78,
4638163,4638203,2022-12-28_10-56-36-784378,4638206,40,
4643271,4643316,2022-12-28_10-56-42-014317,4643325,45,
4648492,4648516,2022-12-28_10-56-47-335588,4648519,24,
4653636,4653709,2022-12-28_10-56-52-655892,4653712,73,
4658734,4658754,2022-12-28_10-56-57-817728,4658757,20,
4663852,4663926,2022-12-28_10-57-03-103971,4663928,74,
4668961,4669026,2022-12-28_10-57-08-323723,4669029,65,
4674067,4674134,2022-12-28_10-57-13-554580,4674137,67,
4679176,4679236,2022-12-28_10-57-18-777100,4679240,60,
4684284,4684332,2022-12-28_10-57-23-996376,4684335,48,
4689382,4689404,2022-12-28_10-57-29-196491,4689406,22,
4694499,4694541,2022-12-28_10-57-34-441410,4694545,42,
4699608,4699631,2022-12-28_10-57-39-658467,4699634,23,
4704753,4704774,2022-12-28_10-57-44-927383,4704777,21,
4709860,4709883,2022-12-28_10-57-50-157223,4709885,23,
4714988,4715014,2022-12-28_10-57-55-398211,4715017,26,
4720105,4720142,2022-12-28_10-58-00-660076,4720145,37,
4725213,4725246,2022-12-28_10-58-05-878497,4725251,33,
4730334,4730368,2022-12-28_10-58-11-106468,4730373,34,
4735438,4735458,2022-12-28_10-58-16-332624,4735461,20,
4740542,4740566,2022-12-28_10-58-21-560000,4740569,24,
4745684,4745771,2022-12-28_10-58-26-884148,4745774,87,
4750796,4750815,2022-12-28_10-58-32-056870,4750818,19,
4755936,4755954,2022-12-28_10-58-37-321594,4755957,18,
4761071,4761091,2022-12-28_10-58-42-576764,4761094,20,
4766189,4766263,2022-12-28_10-58-47-869204,4766267,74,
4771287,4771369,2022-12-28_10-58-53-085361,4771372,82,
4776404,4776492,2022-12-28_10-58-58-334197,4776495,88,
4781513,4781560,2022-12-28_10-59-03-526418,4781563,47,
4786647,4786672,2022-12-28_10-59-08-757015,4786675,25,
4791768,4791787,2022-12-28_10-59-13-997432,4791790,19,
4796881,4796901,2022-12-28_10-59-19-228746,4796904,20,
4802001,4802021,2022-12-28_10-59-24-466273,4802024,20,
4807122,4807185,2022-12-28_10-59-29-749512,4807190,63,
4812252,4812281,2022-12-28_10-59-34-964580,4812283,29,
4817375,4817407,2022-12-28_10-59-40-204675,4817412,32,
4822482,4822504,2022-12-28_10-59-45-435237,4822507,22,
4827603,4827678,2022-12-28_10-59-50-732615,4827681,75,
4832736,4832787,2022-12-28_10-59-55-963664,4832793,51,
4837867,4837889,2022-12-28_11-00-01-188754,4837892,22,
4842986,4843009,2022-12-28_11-00-06-431238,4843011,23,
4848110,4848131,2022-12-28_11-00-11-672661,4848134,21,
4853216,4853237,2022-12-28_11-00-16-904991,4853240,21,
4858333,4858392,2022-12-28_11-00-22-174764,4858396,59,
4863451,4863507,2022-12-28_11-00-27-402489,4863512,56,
4868582,4868603,2022-12-28_11-00-32-629454,4868606,21,
4873720,4873741,2022-12-28_11-00-37-882581,4873746,21,
4878863,4883986,2022-12-28_11-00-43-164687,4883996,5123,
4884009,4884029,2022-12-28_11-00-48-415221,4884032,20,
4889117,4889138,2022-12-28_11-00-53-644242,4889141,21,
4894244,4894302,2022-12-28_11-00-58-930603,4894305,58,
4899388,4899413,2022-12-28_11-01-04-162957,4899416,25,
4904504,4904524,2022-12-28_11-01-09-398630,4904527,20,
4909613,4909633,2022-12-28_11-01-14-633128,4909637,20,
4914732,4914828,2022-12-28_11-01-19-935122,4914834,96,
4919859,4919912,2022-12-28_11-01-25-154720,4919917,53,
4924966,4925018,2022-12-28_11-01-30-370144,4925021,52,
4930068,4930087,2022-12-28_11-01-35-563919,4930090,19,
4935201,4935228,2022-12-28_11-01-40-823691,4935231,27,
4940337,4940363,2022-12-28_11-01-46-082524,4940366,26,
4945475,4945526,2022-12-28_11-01-51-360684,4945529,51,
4950598,4950618,2022-12-28_11-01-56-573015,4950621,20,
4955737,4955757,2022-12-28_11-02-01-840263,4955760,20,
4960846,4960866,2022-12-28_11-02-07-063387,4960869,20,
4965953,4965973,2022-12-28_11-02-12-294925,4965977,20,
4971071,4971092,2022-12-28_11-02-17-535373,4971095,21,
4976202,4976259,2022-12-28_11-02-22-816780,4976264,57,
4981344,4981432,2022-12-28_11-02-28-122510,4981436,88,
4986471,4986565,2022-12-28_11-02-33-374986,4986569,94,
4991583,4991659,2022-12-28_11-02-38-576668,4991664,76,
4996689,4996779,2022-12-28_11-02-43-827439,4996783,90,
5001798,5001849,2022-12-28_11-02-49-013586,5001853,51,
5006907,5006968,2022-12-28_11-02-54-249138,5006973,61,
5012015,5012066,2022-12-28_11-02-59-468901,5012071,51,
5017123,5017172,2022-12-28_11-03-04-694372,5017177,49,
5022230,5022273,2022-12-28_11-03-09-914933,5022279,43,
5027339,5027362,2022-12-28_11-03-15-127783,5027365,23,
5032492,5032562,2022-12-28_11-03-20-451322,5032565,70,
5037624,5037650,2022-12-28_11-03-25-666743,5037653,26,
5042722,5042767,2022-12-28_11-03-30-894551,5042770,45,
5047839,5047867,2022-12-28_11-03-36-120760,5047871,28,
5052947,5052999,2022-12-28_11-03-41-383492,5053003,52,
5058047,5058066,2022-12-28_11-03-46-561918,5058070,19,
5063185,5063207,2022-12-28_11-03-51-823987,5063210,22,
5068292,5068393,2022-12-28_11-03-57-133259,5068396,101,
5073409,5073475,2022-12-28_11-04-02-332512,5073478,66,
5078509,5078530,2022-12-28_11-04-07-501586,5078533,21,
5083664,5083704,2022-12-28_11-04-12-787039,5083710,40,
5088771,5088805,2022-12-28_11-04-18-012488,5088810,34,
5093878,5093898,2022-12-28_11-04-23-232957,5093903,20,
5099052,5099104,2022-12-28_11-04-28-551391,5099107,52,
5104184,5104203,2022-12-28_11-04-33-786148,5104207,19,
5109339,5109386,2022-12-28_11-04-39-091064,5109389,47,
5114446,5114471,2022-12-28_11-04-44-294970,5114474,25,
5119604,5119691,2022-12-28_11-04-49-642091,5119693,87,
5124703,5124724,2022-12-28_11-04-54-788579,5124726,21,
5129810,5129831,2022-12-28_11-05-00-021000,5129834,21,
5134955,5135012,2022-12-28_11-05-05-318429,5135017,57,
5140063,5140110,2022-12-28_11-05-10-536642,5140116,47,
5145170,5145215,2022-12-28_11-05-15-759539,5145218,45,
5150269,5150309,2022-12-28_11-05-20-952366,5150312,40,
5155384,5155421,2022-12-28_11-05-26-204303,5155426,37,
5160495,5160542,2022-12-28_11-05-31-438047,5160545,47,
5165603,5165624,2022-12-28_11-05-36-652032,5165627,21,
5170746,5170766,2022-12-28_11-05-41-915753,5170769,20,
5175866,5175924,2022-12-28_11-05-47-192853,5175927,58,
5180972,5181031,2022-12-28_11-05-52-426863,5181034,59,
5186085,5186126,2022-12-28_11-05-57-647676,5186129,41,
5191189,5191210,2022-12-28_11-06-02-849125,5191214,21,
5196335,5196405,2022-12-28_11-06-08-166620,5196414,70,
5201431,5201450,2022-12-28_11-06-13-339326,5201454,19,
5206567,5206589,2022-12-28_11-06-18-591939,5206592,22,
5211675,5211696,2022-12-28_11-06-23-821392,5211699,21,
5216827,5216848,2022-12-28_11-06-29-095878,5216851,21,
5221933,5221955,2022-12-28_11-06-34-327394,5221958,22,
5227042,5227162,2022-12-28_11-06-39-633479,5232180,120,
5232192,5232213,2022-12-28_11-06-44-820088,5232216,21,
5237303,5237365,2022-12-28_11-06-50-097498,5237368,62,
5242438,5247541,2022-12-28_11-06-55-309240,5247549,5103,
5247569,5247643,2022-12-28_11-07-00-618363,5247648,74,
5252693,5252761,2022-12-28_11-07-05-847479,5252768,68,
5257814,5257855,2022-12-28_11-07-11-067479,5257860,41,
5262944,5262964,2022-12-28_11-07-16-304041,5262967,20,
5268063,5268082,2022-12-28_11-07-21-547063,5268085,19,
5273188,5273280,2022-12-28_11-07-26-853361,5273283,92,
5278308,5278361,2022-12-28_11-07-32-062527,5278366,53,
5283444,5283463,2022-12-28_11-07-37-289140,5283467,19,
5288570,5288596,2022-12-28_11-07-42-533615,5288599,26,
5293701,5293779,2022-12-28_11-07-47-853754,5293782,78,
5298843,5298871,2022-12-28_11-07-53-052988,5298876,28,
5303986,5304007,2022-12-28_11-07-58-319226,5304010,21,
5309107,5309129,2022-12-28_11-08-03-564561,5309133,22,
5314240,5314268,2022-12-28_11-08-08-820902,5314274,28,
5319404,5319428,2022-12-28_11-08-14-102141,5319431,24,
5324511,5324533,2022-12-28_11-08-19-323706,5324536,22,
5329630,5329663,2022-12-28_11-08-24-584025,5329666,33,
5334759,5334784,2022-12-28_11-08-29-819580,5334786,25,
5339908,5339988,2022-12-28_11-08-35-138109,5339991,80,
5345015,5345035,2022-12-28_11-08-40-309584,5345038,20,
5350143,5350183,2022-12-28_11-08-45-583407,5350185,40,
5355282,5355314,2022-12-28_11-08-50-817904,5355319,32,
5360396,5360476,2022-12-28_11-08-56-123791,5360479,80,
5365526,5365606,2022-12-28_11-09-01-362621,5365612,80,
5370646,5370680,2022-12-28_11-09-06-562240,5370683,34,
5375770,5375825,2022-12-28_11-09-11-832420,5375827,55,
5380888,5385992,2022-12-28_11-09-17-154945,5386008,5104,
5386029,5386083,2022-12-28_11-09-22-336975,5386087,54,
5391103,5391124,2022-12-28_11-09-27-496995,5391127,21,
5396223,5396300,2022-12-28_11-09-32-792426,5396306,77,
5401360,5401389,2022-12-28_11-09-38-005028,5401392,29,
5406498,5406520,2022-12-28_11-09-43-252292,5406523,22,
5411619,5411638,2022-12-28_11-09-48-496767,5411641,19,
5416727,5416748,2022-12-28_11-09-53-724887,5416751,21,
5421844,5421902,2022-12-28_11-09-58-997460,5421905,58,
5426952,5427011,2022-12-28_11-10-04-227221,5427016,59,
5432058,5432135,2022-12-28_11-10-09-457870,5432140,77,
5437158,5437211,2022-12-28_11-10-14-668781,5437214,53,
5442276,5442313,2022-12-28_11-10-19-896435,5442318,37,
5447383,5447426,2022-12-28_11-10-25-120182,5447429,43,
5452491,5452515,2022-12-28_11-10-30-329619,5452523,24,
5457599,5457620,2022-12-28_11-10-35-561312,5457622,21,
5462736,5462757,2022-12-28_11-10-40-817739,5462761,21,
5467843,5467880,2022-12-28_11-10-46-063747,5467883,37,
5472958,5473021,2022-12-28_11-10-51-328483,5473027,63,
5478067,5478134,2022-12-28_11-10-56-551126,5478139,67,
5483174,5483233,2022-12-28_11-11-01-773567,5483239,59,
5488285,5488324,2022-12-28_11-11-06-998948,5488330,39,
5493408,5493429,2022-12-28_11-11-12-223836,5493432,21,
5498522,5498550,2022-12-28_11-11-17-469336,5498552,28,
5503697,5503720,2022-12-28_11-11-22-768743,5503722,23,
5508844,5508920,2022-12-28_11-11-28-084740,5508923,76,
5513954,5514027,2022-12-28_11-11-33-316078,5514030,73,
5519059,5519132,2022-12-28_11-11-38-535767,5519137,73,
5524266,5524333,2022-12-28_11-11-43-856738,5524336,67,
5529372,5529440,2022-12-28_11-11-49-083094,5529445,68,
5534481,5534555,2022-12-28_11-11-54-324169,5534558,74,
5539586,5539639,2022-12-28_11-11-59-527779,5539642,53,
5544696,5544753,2022-12-28_11-12-04-760298,5544758,57,
5549806,5549845,2022-12-28_11-12-09-976148,5549848,39,
5554914,5554954,2022-12-28_11-12-15-200249,5554959,40,
5560021,5560056,2022-12-28_11-12-20-425612,5560061,35,
5565124,5565146,2022-12-28_11-12-25-640402,5565149,22,
5570290,5570348,2022-12-28_11-12-30-964026,5570351,58,
5575398,5575446,2022-12-28_11-12-36-182684,5575449,48,
5580505,5580552,2022-12-28_11-12-41-413417,5580556,47,
5585613,5585661,2022-12-28_11-12-46-636393,5585666,48,
5590712,5590732,2022-12-28_11-12-51-824690,5590735,20,
5595840,5595871,2022-12-28_11-12-57-081641,5595874,31,
5600940,5600959,2022-12-28_11-13-02-293807,5600962,19,
5606083,5606105,2022-12-28_11-13-07-556288,5606108,22,
5611201,5611272,2022-12-28_11-13-12-843825,5611275,71,
5616307,5616386,2022-12-28_11-13-18-075323,5616392,79,
5621414,5621434,2022-12-28_11-13-23-246964,5621438,20,
5626543,5626606,2022-12-28_11-13-28-541650,5626609,63,
5631651,5631688,2022-12-28_11-13-33-737361,5631693,37,
5636759,5636787,2022-12-28_11-13-38-963118,5636790,28,
5641874,5641894,2022-12-28_11-13-44-193312,5641897,20,
5647011,5647031,2022-12-28_11-13-49-446571,5647033,20,
5652119,5652139,2022-12-28_11-13-54-677387,5652142,20,
5657227,5657249,2022-12-28_11-13-59-907726,5657252,22,
5662346,5662364,2022-12-28_11-14-05-141854,5662367,18,
5667479,5667500,2022-12-28_11-14-10-405899,5667504,21,
5672601,5672622,2022-12-28_11-14-15-649679,5672624,21,
5677709,5677730,2022-12-28_11-14-20-871769,5677733,21,
5682837,5682857,2022-12-28_11-14-26-124147,5682860,20,
5687961,5688005,2022-12-28_11-14-31-392696,5688009,44,
5693097,5693141,2022-12-28_11-14-36-651122,5693144,44,
5698207,5698228,2022-12-28_11-14-41-865163,5698230,21,
5703348,5703370,2022-12-28_11-14-47-124625,5703373,22,
5708474,5713608,2022-12-28_11-14-52-385580,5713618,5134,
5713639,5713707,2022-12-28_11-14-57-701385,5713710,68,
5718754,5718792,2022-12-28_11-15-02-908539,5718795,38,
5723888,5723922,2022-12-28_11-15-08-155504,5723927,34,
5729022,5729042,2022-12-28_11-15-13-402508,5729045,20,
5734149,5734171,2022-12-28_11-15-18-645985,5734174,22,
5739255,5739290,2022-12-28_11-15-23-883063,5739293,35,
5744374,5744431,2022-12-28_11-15-29-143550,5744436,57,
5749497,5749542,2022-12-28_11-15-34-375084,5749544,45,
5754624,5754644,2022-12-28_11-15-39-600274,5754648,20,
5759756,5759778,2022-12-28_11-15-44-854646,5759781,22,
5764879,5764946,2022-12-28_11-15-50-142347,5764950,67,
5769986,5770033,2022-12-28_11-15-55-346788,5770036,47,
5775122,5775155,2022-12-28_11-16-00-585329,5775161,33,
5780241,5780262,2022-12-28_11-16-05-819529,5780265,21,
5785357,5785377,2022-12-28_11-16-11-050903,5785380,20,
5790491,5790571,2022-12-28_11-16-16-355865,5790576,80,
5795628,5795652,2022-12-28_11-16-21-569588,5795654,24,
5800744,5800765,2022-12-28_11-16-26-799484,5800767,21,
5805888,5805909,2022-12-28_11-16-32-063477,5805912,21,
5811004,5811054,2022-12-28_11-16-37-338083,5811064,50,
5816144,5816165,2022-12-28_11-16-42-568570,5816168,21,
5821252,5821276,2022-12-28_11-16-47-796398,5821281,24,
5826375,5826398,2022-12-28_11-16-53-046512,5826400,23,
5831482,5831562,2022-12-28_11-16-58-334759,5831566,80,
5836593,5836666,2022-12-28_11-17-03-557563,5836671,73,
5841688,5841711,2022-12-28_11-17-08-727160,5841713,23,
5846815,5846874,2022-12-28_11-17-14-005668,5846877,59,
5851924,5851975,2022-12-28_11-17-19-231221,5851978,51,
5857032,5857077,2022-12-28_11-17-24-450135,5857080,45,
5862141,5862182,2022-12-28_11-17-29-672962,5862185,41,
5867248,5867304,2022-12-28_11-17-34-922451,5867307,56,
5872357,5872378,2022-12-28_11-17-40-117688,5872382,21,
5877463,5877505,2022-12-28_11-17-45-364291,5877508,42,
5882568,5882609,2022-12-28_11-17-50-589861,5882613,41,
5887671,5892802,2022-12-28_11-17-55-939933,5892806,5131,
5892806,5892827,2022-12-28_11-18-01-053211,5892830,21,
5897965,5898011,2022-12-28_11-18-06-359680,5898014,46,
5903073,5903100,2022-12-28_11-18-11-561885,5903105,27,
5908237,5908300,2022-12-28_11-18-16-885108,5908305,63,
5913344,5913395,2022-12-28_11-18-22-097373,5913400,51,
5918452,5918494,2022-12-28_11-18-27-326988,5918499,42,
5923558,5923615,2022-12-28_11-18-32-551604,5923620,57,
5928672,5928704,2022-12-28_11-18-37-773430,5928710,32,
5933771,5933800,2022-12-28_11-18-42-981517,5933803,29,
5938914,5938935,2022-12-28_11-18-48-242470,5938938,21,
5944030,5944112,2022-12-28_11-18-53-536776,5944118,82,
5949130,5949150,2022-12-28_11-18-58-694506,5949153,20,
5954269,5954318,2022-12-28_11-19-03-984667,5954320,49,
5959367,5964494,2022-12-28_11-19-09-210558,5964506,5127,
5964518,5964614,2022-12-28_11-19-14-525348,5964617,96,
5969626,5969649,2022-12-28_11-19-19-677558,5969652,23,
5974734,5974822,2022-12-28_11-19-24-973566,5974825,88,
5979854,5979921,2022-12-28_11-19-30-193596,5979924,67,
5984954,5985027,2022-12-28_11-19-35-418558,5985029,73,
5990079,5990132,2022-12-28_11-19-40-636789,5990135,53,
5995186,5995238,2022-12-28_11-19-45-863707,5995243,52,
6000293,6000350,2022-12-28_11-19-51-090544,6000355,57,
6005401,6005458,2022-12-28_11-19-56-314010,6005463,57,
6010510,6010547,2022-12-28_11-20-01-535841,6010552,37,
6015618,6015653,2022-12-28_11-20-06-758069,6015658,35,
6020726,6020752,2022-12-28_11-20-11-978662,6020755,26,