RD,TS_received,TS_sent,AK,RoundTrip,
282768,287884,2022-11-30_09-08-20-766225,287892,5116,
287905,287948,2022-11-30_09-08-25-793446,287951,43,
293005,298133,2022-11-30_09-08-31-066468,298141,5128,
298154,298257,2022-11-30_09-08-36-345160,298260,103,
303237,308344,2022-11-30_09-08-41-565641,308346,5107,
308347,313467,2022-11-30_09-08-46-789107,313481,5120,
313502,313570,2022-11-30_09-08-52-012831,313573,68,
318577,318599,2022-11-30_09-08-57-151458,318608,22,
323693,328822,2022-11-30_09-09-02-459774,328838,5129,
328859,328905,2022-11-30_09-09-07-691526,328911,46,
333935,339044,2022-11-30_09-09-12-959402,339060,5109,
339077,339101,2022-11-30_09-09-18-127283,339104,24,
344158,344202,2022-11-30_09-09-23-351299,344204,44,
349286,349306,2022-11-30_09-09-28-576045,349309,20,
354410,359531,2022-11-30_09-09-33-899178,359539,5121,
359559,359610,2022-11-30_09-09-39-122805,359613,51,
364691,0,,369801,-364691,
369813,369833,2022-11-30_09-09-49-575125,369835,20,
374963,380077,2022-11-30_09-09-54-997917,380085,5114,
380104,380129,2022-11-30_09-10-00-112296,380132,25,
385196,385237,2022-11-30_09-10-05-335915,385241,41,
390327,390373,2022-11-30_09-10-10-593456,390389,46,
395464,395485,2022-11-30_09-10-15-823604,395488,21,
400591,405729,2022-11-30_09-10-21-360148,405740,5138,
405752,405773,2022-11-30_09-10-26-345477,405776,21,
410847,410868,2022-11-30_09-10-31-561058,410871,21,
415967,415987,2022-11-30_09-10-36-790332,415990,20,
421099,421174,2022-11-30_09-10-42-104965,421177,75,
426246,426329,2022-11-30_09-10-47-367616,426332,83,
431374,431394,2022-11-30_09-10-52-556281,431397,20,
436483,436522,2022-11-30_09-10-57-797090,436525,39,
441648,441732,2022-11-30_09-11-03-129373,441735,84,
446755,446809,2022-11-30_09-11-08-322657,446814,54,
451853,451873,2022-11-30_09-11-13-502404,451876,20,
456988,457030,2022-11-30_09-11-18-774639,457036,42,
462096,462145,2022-11-30_09-11-23-996982,462150,49,
467205,467254,2022-11-30_09-11-29-239356,467257,49,
472313,472339,2022-11-30_09-11-34-439516,472342,26,
477443,477465,2022-11-30_09-11-39-686386,477467,22,
482682,482737,2022-11-30_09-11-45-082018,482740,55,
487831,487851,2022-11-30_09-11-50-313866,487854,20,
492937,492962,2022-11-30_09-11-55-539551,492967,25,
498067,498088,2022-11-30_09-12-00-787069,498091,21,
503183,503203,2022-11-30_09-12-06-012690,503206,20,
508323,508375,2022-11-30_09-12-11-302280,508377,52,
513420,513443,2022-11-30_09-12-16-491109,513447,23,
518553,518579,2022-11-30_09-12-21-758125,518582,26,
523661,523686,2022-11-30_09-12-26-980123,523691,25,
528808,528886,2022-11-30_09-12-32-307309,528889,78,
533914,533972,2022-11-30_09-12-37-518235,533975,58,
539027,539084,2022-11-30_09-12-42-754097,539087,57,
544135,544204,2022-11-30_09-12-47-984360,544208,69,
549242,549282,2022-11-30_09-12-53-187545,549285,40,
554370,554400,2022-11-30_09-12-58-419047,554403,30,
559477,559543,2022-11-30_09-13-03-669745,559546,66,
564582,564612,2022-11-30_09-13-08-868423,564617,30,
569689,569711,2022-11-30_09-13-14-100238,569714,22,
574845,574904,2022-11-30_09-13-19-415596,574908,59,
579953,579999,2022-11-30_09-13-24-636668,580004,46,
585061,590159,2022-11-30_09-13-29-987683,590162,5098,
590162,590183,2022-11-30_09-13-35-061569,590186,21,
595296,595317,2022-11-30_09-13-40-307532,595320,21,
600459,600509,2022-11-30_09-13-45-624702,600512,50,
605559,605661,2022-11-30_09-13-50-888801,605664,102,
610695,610726,2022-11-30_09-13-56-079225,610731,31,
615800,615830,2022-11-30_09-14-01-311612,615833,30,
620911,620941,2022-11-30_09-14-06-532531,620946,30,
626012,626035,2022-11-30_09-14-11-756072,626037,23,
631140,631161,2022-11-30_09-14-17-000446,631164,21,
636255,636274,2022-11-30_09-14-22-234989,636277,19,
641400,641429,2022-11-30_09-14-27-515787,641432,29,
646538,646560,2022-11-30_09-14-32-774144,646563,22,
651656,651678,2022-11-30_09-14-38-007850,651681,22,
656782,656848,2022-11-30_09-14-43-292161,656853,66,
661890,661943,2022-11-30_09-14-48-510506,661946,53,
667009,667030,2022-11-30_09-14-53-722563,667033,21,
672159,672181,2022-11-30_09-14-58-999566,672183,22,
677271,677291,2022-11-30_09-15-04-233483,677293,20,
682379,682399,2022-11-30_09-15-09-456982,682402,20,
687511,687530,2022-11-30_09-15-14-710123,687533,19,
692641,692660,2022-11-30_09-15-19-958304,692663,19,
697749,697769,2022-11-30_09-15-25-196986,697771,20,
702875,702896,2022-11-30_09-15-30-436838,702899,21,
707996,713109,2022-11-30_09-15-35-770918,713118,5113,
713134,713170,2022-11-30_09-15-40-942961,713176,36,
718228,718262,2022-11-30_09-15-46-169422,718267,34,
723381,723401,2022-11-30_09-15-51-439080,723404,20,
728492,728511,2022-11-30_09-15-56-669625,728514,19,
733609,733665,2022-11-30_09-16-01-942081,733667,56,
738726,738751,2022-11-30_09-16-07-137923,738753,25,
743851,743871,2022-11-30_09-16-12-392003,743874,20,
748974,748996,2022-11-30_09-16-17-633998,748999,22,
754117,754170,2022-11-30_09-16-22-936480,754176,53,
759245,759285,2022-11-30_09-16-28-162330,759290,40,
764351,769465,2022-11-30_09-16-33-483965,769474,5114,
769489,769575,2022-11-30_09-16-38-697045,769578,86,
774574,774683,2022-11-30_09-16-43-926999,779702,109,
779723,779810,2022-11-30_09-16-49-169773,779812,87,
784845,784884,2022-11-30_09-16-54-367906,784887,39,
789971,790007,2022-11-30_09-16-59-605717,790012,36,
795095,795116,2022-11-30_09-17-04-852185,795118,21,
800203,800289,2022-11-30_09-17-10-147604,800292,86,
805311,805333,2022-11-30_09-17-15-306559,805336,22,
810445,810499,2022-11-30_09-17-20-593074,810503,54,
815568,815609,2022-11-30_09-17-25-822100,815615,41,
820708,820727,2022-11-30_09-17-31-057079,820731,19,
825839,825945,2022-11-30_09-17-36-383232,830968,106,
830991,831034,2022-11-30_09-17-41-598737,831036,43,
836071,836095,2022-11-30_09-17-46-791596,836098,24,
841206,841226,2022-11-30_09-17-52-038666,841229,20,
846326,846347,2022-11-30_09-17-57-276550,846349,21,
851443,851522,2022-11-30_09-18-02-577932,851526,79,
856544,856567,2022-11-30_09-18-07-748440,856570,23,
861653,861735,2022-11-30_09-18-13-028889,861739,82,
866773,866795,2022-11-30_09-18-18-214177,866798,22,
871914,871942,2022-11-30_09-18-23-481310,871944,28,
877027,877135,2022-11-30_09-18-28-805384,882172,108,
882193,882234,2022-11-30_09-18-34-018773,882237,41,
887278,887311,2022-11-30_09-18-39-212099,887314,33,
892385,892443,2022-11-30_09-18-44-466863,892447,58,
897502,897534,2022-11-30_09-18-49-679520,897537,32,
902610,902662,2022-11-30_09-18-54-912740,902665,52,
907715,907754,2022-11-30_09-19-00-138837,907758,39,
912852,912872,2022-11-30_09-19-05-382307,912875,20,
917996,918016,2022-11-30_09-19-10-648632,918019,20,
923113,923143,2022-11-30_09-19-15-896173,923146,30,
928216,928263,2022-11-30_09-19-21-130376,928265,47,
933329,933381,2022-11-30_09-19-26-356320,933384,52,
938427,938449,2022-11-30_09-19-31-565252,938452,22,
943542,943566,2022-11-30_09-19-36-804335,943569,24,
948651,948674,2022-11-30_09-19-42-029460,948677,23,
953757,953782,2022-11-30_09-19-47-253296,953787,25,
958862,958884,2022-11-30_09-19-52-480730,958887,22,
964004,964085,2022-11-30_09-19-57-804730,964090,81,
969113,969188,2022-11-30_09-20-03-026837,969192,75,
974212,974306,2022-11-30_09-20-08-272663,974309,94,
979328,984461,2022-11-30_09-20-13-468404,984470,5133,
984482,984507,2022-11-30_09-20-18-713939,984510,25,
989571,994686,2022-11-30_09-20-24-091741,994689,5115,
994689,994711,2022-11-30_09-20-29-162512,994713,22,
999797,999834,2022-11-30_09-20-34-405117,999837,37,
1004895,1004915,2022-11-30_09-20-39-608851,1004919,20,
1010028,1010083,2022-11-30_09-20-44-900650,1010085,55,
1015140,1015160,2022-11-30_09-20-50-097086,1015164,20,
1020252,1020306,2022-11-30_09-20-55-350133,1020311,54,
1025363,1025387,2022-11-30_09-21-00-565530,1025390,24,
1030464,1030499,2022-11-30_09-21-05-799204,1030502,35,
1035611,1035636,2022-11-30_09-21-11-048539,1035638,25,
1040718,1040742,2022-11-30_09-21-16-287375,1040745,24,
1045861,1045905,2022-11-30_09-21-21-566780,1045907,44,
1050990,1051022,2022-11-30_09-21-26-793701,1051025,32,
1056099,1056130,2022-11-30_09-21-32-028569,1056135,31,
1061241,1061260,2022-11-30_09-21-37-290370,1061264,19,
1066361,1066442,2022-11-30_09-21-42-583410,1066445,81,
1071504,1071524,2022-11-30_09-21-47-793789,1071528,20,
1076623,1076642,2022-11-30_09-21-53-035823,1076645,19,
1081731,1081751,2022-11-30_09-21-58-262656,1081754,20,
1086852,1086871,2022-11-30_09-22-03-502309,1086875,19,
1091963,1091983,2022-11-30_09-22-08-736838,1091986,20,
1097072,1097100,2022-11-30_09-22-13-967567,1097103,28,
1102210,1102230,2022-11-30_09-22-19-224609,1102233,20,
1107347,1107369,2022-11-30_09-22-24-477520,1107371,22,
1112477,1112551,2022-11-30_09-22-29-782990,1112554,74,
1117597,1117644,2022-11-30_09-22-35-002300,1117650,47,
1122704,1122748,2022-11-30_09-22-40-224048,1122750,44,
1127839,1127859,2022-11-30_09-22-45-458868,1127862,20,
1132950,1132970,2022-11-30_09-22-50-690696,1132973,20,
1138060,1138079,2022-11-30_09-22-55-922465,1138082,19,
1143184,1143256,2022-11-30_09-23-01-224393,1143273,72,
1148306,1148361,2022-11-30_09-23-06-443393,1148364,55,
1153397,1153419,2022-11-30_09-23-11-625178,1153422,22,
1158524,1163666,2022-11-30_09-23-16-889444,1163674,5142,
1163686,1163738,2022-11-30_09-23-22-192672,1163741,52,
1168811,0,,1173945,-1168811,
1173957,1173980,2022-11-30_09-23-32-668234,1173982,23,
1179097,1179119,2022-11-30_09-23-37-927235,1179122,22,
1184205,1184234,2022-11-30_09-23-43-170975,1184237,29,
1189321,1189378,2022-11-30_09-23-48-430251,1189384,57,
1194432,1194462,2022-11-30_09-23-53-622690,1194465,30,
1199561,1199581,2022-11-30_09-23-58-880636,1199584,20,
1204695,1204715,2022-11-30_09-24-04-131530,1204718,20,
1209814,1209922,2022-11-30_09-24-09-454866,1214924,108,
1214937,1214960,2022-11-30_09-24-14-618644,1214963,23,
1220086,1220121,2022-11-30_09-24-19-899704,1220124,35,
1225182,1225211,2022-11-30_09-24-25-104839,1225217,29,
1230305,1230326,2022-11-30_09-24-30-348481,1230329,21,
1235421,0,,1240534,-1235421,
1240549,1240609,2022-11-30_09-24-40-865647,1240612,60,
1245656,1245700,2022-11-30_09-24-46-085320,1245703,44,
1250788,1250809,2022-11-30_09-24-51-312946,1250813,21,
1255920,1255946,2022-11-30_09-24-56-566878,1255949,26,
1261028,1261046,2022-11-30_09-25-01-794529,1261049,18,
1266152,1266225,2022-11-30_09-25-07-090202,1266228,73,
1271262,1271283,2022-11-30_09-25-12-271390,1271286,21,
1276370,1276418,2022-11-30_09-25-17-529697,1276420,48,
1281487,1281516,2022-11-30_09-25-22-744767,1281519,29,
1286585,1286609,2022-11-30_09-25-27-961335,1286612,24,
1291726,1291747,2022-11-30_09-25-33-228432,1291749,21,
1296833,1296863,2022-11-30_09-25-38-453485,1296866,30,
1301980,1302033,2022-11-30_09-25-43-754486,1302038,53,
1307091,1307148,2022-11-30_09-25-48-985028,1307151,57,
1312198,1312240,2022-11-30_09-25-54-199473,1312243,42,
1317306,1317337,2022-11-30_09-25-59-417953,1317341,31,
1322405,1322428,2022-11-30_09-26-04-636059,1322432,23,
1327542,1327561,2022-11-30_09-26-09-883122,1327565,19,
1332657,1332733,2022-11-30_09-26-15-181837,1332736,76,
1337767,1337830,2022-11-30_09-26-20-406218,1337833,63,
1342998,1343056,2022-11-30_09-26-25-736421,1343059,58,
1348105,1348176,2022-11-30_09-26-30-972837,1348181,71,
1353204,1353224,2022-11-30_09-26-36-157939,1353227,20,
1358353,1358373,2022-11-30_09-26-41-427941,1358375,20,
1363485,1363575,2022-11-30_09-26-46-743179,1363581,90,
1368601,1368677,2022-11-30_09-26-51-975345,1368680,76,
1373702,1373774,2022-11-30_09-26-57-175085,1373779,72,
1378817,1378864,2022-11-30_09-27-02-411664,1378868,47,
1383929,1383966,2022-11-30_09-27-07-626809,1383971,37,
1389037,1389059,2022-11-30_09-27-12-838917,1389062,22,
1394172,1394207,2022-11-30_09-27-18-116816,1394210,35,
1399314,1399397,2022-11-30_09-27-23-406558,1399402,83,
1404414,1404444,2022-11-30_09-27-28-580909,1404447,30,
1409521,1409541,2022-11-30_09-27-33-809429,1409544,20,
1414637,1414687,2022-11-30_09-27-39-061572,1414692,50,
1419737,1419758,2022-11-30_09-27-44-262261,1419760,21,
1424866,1424891,2022-11-30_09-27-49-515959,1424894,25,
1429973,1429995,2022-11-30_09-27-54-748154,1429997,22,
1435133,1435153,2022-11-30_09-28-00-023080,1435155,20,
1440250,1440300,2022-11-30_09-28-05-275813,1440306,50,
1445357,1445391,2022-11-30_09-28-10-505032,1445396,34,
1450506,1450527,2022-11-30_09-28-15-764626,1450530,21,
1455616,1455692,2022-11-30_09-28-21-054812,1455695,76,
1460723,1460805,2022-11-30_09-28-26-277529,1460810,82,
1465841,1465919,2022-11-30_09-28-31-508244,1465924,78,
1470947,1476084,2022-11-30_09-28-36-838224,1476093,5137,
1476093,1476113,2022-11-30_09-28-41-957008,1476117,20,
1481206,1481227,2022-11-30_09-28-47-191868,1481230,21,
1486332,1491445,2022-11-30_09-28-52-555483,1491461,5113,
1491482,1491507,2022-11-30_09-28-57-718773,1491511,25,
1496549,1496569,2022-11-30_09-29-02-894992,1496572,20,
1501673,1501701,2022-11-30_09-29-08-151460,1501704,28,
1506806,0,,1506915,-1506806,
1511928,1512012,2022-11-30_09-29-18-702580,1512014,84,
1517044,1517065,2022-11-30_09-29-23-880556,1517069,21,
1522173,1522247,2022-11-30_09-29-29-161463,1522250,74,
1527306,1527333,2022-11-30_09-29-34-386701,1527336,27,
1532434,1532455,2022-11-30_09-29-39-636983,1532458,21,
1537555,1537655,2022-11-30_09-29-44-952825,1537658,100,
1542662,1542731,2022-11-30_09-29-50-152866,1542734,69,
1547806,1547851,2022-11-30_09-29-55-385124,1547857,45,
1552931,1552951,2022-11-30_09-30-00-602894,1552954,20,
1558047,1558077,2022-11-30_09-30-05-840286,1558080,30,
1563204,0,,1568329,-1563204,
1568341,1568361,2022-11-30_09-30-16-378872,1568364,20,
1573476,1573498,2022-11-30_09-30-21-639926,1573501,22,
1578576,1578668,2022-11-30_09-30-26-910908,1578671,92,
1583701,1583762,2022-11-30_09-30-32-146871,1583767,61,
1588836,1588857,2022-11-30_09-30-37-364800,1588860,21,
1593950,1593980,2022-11-30_09-30-42-603538,1593983,30,
1599090,1599176,2022-11-30_09-30-47-921752,1599182,86,
1604206,1604278,2022-11-30_09-30-53-138114,1604284,72,
1609349,1609380,2022-11-30_09-30-58-361735,1609386,31,
1614481,1614567,2022-11-30_09-31-03-677601,1614569,86,
1619606,1619626,2022-11-30_09-31-08-863649,1619629,20,
1624731,1624781,2022-11-30_09-31-14-134290,1624784,50,
1629867,1629901,2022-11-30_09-31-19-375288,1629905,34,
1634999,1635024,2022-11-30_09-31-24-621988,1635027,25,
1640122,1640196,2022-11-30_09-31-29-905921,1640199,74,
1645231,1645304,2022-11-30_09-31-35-131904,1645309,73,
1650371,1650393,2022-11-30_09-31-40-350387,1650395,22,
1655491,1655511,2022-11-30_09-31-45-589488,1655514,20,
1660599,1660619,2022-11-30_09-31-50-819873,1660622,20,
1665706,1670811,2022-11-30_09-31-56-052643,1670821,5105,
1670839,1670910,2022-11-30_09-32-01-344807,1670912,71,
1675973,1676015,2022-11-30_09-32-06-575131,1676021,42,
1681127,1681148,2022-11-30_09-32-11-826859,1681151,21,
1686244,1686276,2022-11-30_09-32-17-078791,1686278,32,
1691352,1691372,2022-11-30_09-32-22-296121,1691375,20,
1696500,1696524,2022-11-30_09-32-27-569129,1696527,24,
1701647,1701720,2022-11-30_09-32-32-888773,1701722,73,
1706755,1706834,2022-11-30_09-32-38-113921,1706840,79,
1711865,1711944,2022-11-30_09-32-43-353633,1711947,79,
1716966,1717035,2022-11-30_09-32-48-552962,1717040,69,
1722079,1722121,2022-11-30_09-32-53-774715,1722124,42,
1727189,1727219,2022-11-30_09-32-58-996152,1727221,30,
1732287,1732308,2022-11-30_09-33-04-202144,1732311,21,
1737438,1737485,2022-11-30_09-33-09-497034,1737488,47,
1742545,1742565,2022-11-30_09-33-14-701734,1742568,20,
1747670,1747690,2022-11-30_09-33-19-947135,1747693,20,
1752813,1752849,2022-11-30_09-33-25-214772,1752851,36,
1757922,1757970,2022-11-30_09-33-30-468570,1757974,48,
1763029,1763056,2022-11-30_09-33-35-671167,1763062,27,
1768178,1768198,2022-11-30_09-33-40-937822,1768201,20,
1773296,1773347,2022-11-30_09-33-46-214619,1773350,51,
1778402,1778483,2022-11-30_09-33-51-449684,1778488,81,
1783523,1783553,2022-11-30_09-33-56-653581,1783556,30,
1788630,1788658,2022-11-30_09-34-01-885150,1788660,28,
1793739,1793861,2022-11-30_09-34-07-209199,1798870,122,
1798882,1798988,2022-11-30_09-34-12-452657,1803994,106,
1804017,1804062,2022-11-30_09-34-17-647749,1804065,45,
1809101,1809122,2022-11-30_09-34-22-823770,1809125,21,
1814218,1814275,2022-11-30_09-34-28-097323,1814279,57,
1819326,1819378,2022-11-30_09-34-33-326135,1819381,52,
1824457,1824497,2022-11-30_09-34-38-558579,1824502,40,
1829563,1829686,2022-11-30_09-34-43-872616,1834661,123,
1834680,1834770,2022-11-30_09-34-49-085983,1834773,90,
1839813,1839907,2022-11-30_09-34-54-324943,1839913,94,
1844921,1844942,2022-11-30_09-34-59-495005,1844945,21,
1850037,1850097,2022-11-30_09-35-04-766417,1850100,60,
1855145,1855195,2022-11-30_09-35-09-985294,1855198,50,
1860291,1860312,2022-11-30_09-35-15-233950,1860315,21,
1865416,1865514,2022-11-30_09-35-20-561382,1865516,98,
1870514,1870549,2022-11-30_09-35-25-700358,1870551,35,
1875622,1875645,2022-11-30_09-35-30-923066,1875647,23,
1880755,1880774,2022-11-30_09-35-36-178048,1880777,19,
1885875,1885907,2022-11-30_09-35-41-423280,1885910,32,
1890988,1891041,2022-11-30_09-35-46-663613,1891044,53,
1896093,1896208,2022-11-30_09-35-51-977426,1901223,115,
1901235,1901269,2022-11-30_09-35-57-152664,1901272,34,
1906354,1906429,2022-11-30_09-36-02-428113,1906434,75,
1911496,1911521,2022-11-30_09-36-07-653662,1911526,25,
1916621,1916721,2022-11-30_09-36-12-963856,1916724,100,
1921754,1921833,2022-11-30_09-36-18-202482,1921839,79,
1926862,1926918,2022-11-30_09-36-23-411040,1926922,56,
1931987,1932067,2022-11-30_09-36-28-679842,1932070,80,
1937121,0,,1937220,-1937121,
1942261,1942294,2022-11-30_09-36-39-148170,1942296,33,
1947402,1947442,2022-11-30_09-36-44-416747,1947448,40,
1952531,1952584,2022-11-30_09-36-49-684330,1952588,53,
1957666,1957731,2022-11-30_09-36-54-953276,1957734,65,
1962806,1962846,2022-11-30_09-37-00-188146,1962851,40,
1967941,1967963,2022-11-30_09-37-05-426377,1967965,22,
1973077,1973147,2022-11-30_09-37-10-736026,1973151,70,
1978204,1978263,2022-11-30_09-37-15-964220,1978269,59,
1983332,1983366,2022-11-30_09-37-21-192353,1983369,34,
1988457,1988478,2022-11-30_09-37-26-422656,1988481,21,
1993575,1993594,2022-11-30_09-37-31-667463,1993597,19,
1998691,1998748,2022-11-30_09-37-36-950617,1998751,57,
2003830,2003866,2022-11-30_09-37-42-178467,2003871,36,
2008991,2009059,2022-11-30_09-37-47-498969,2009062,68,
2014101,2014121,2022-11-30_09-37-52-677841,2014124,20,
2019228,2019289,2022-11-30_09-37-57-957119,2019294,61,
2024354,2024398,2022-11-30_09-38-03-171474,2024401,44,
2029480,2029499,2022-11-30_09-38-08-415814,2029502,19,
2034603,2034624,2022-11-30_09-38-13-664348,2034627,21,
2039726,2039748,2022-11-30_09-38-18-907898,2039752,22,
2044860,2044895,2022-11-30_09-38-24-167782,2044901,35,
2049970,2049990,2022-11-30_09-38-29-395969,2049993,20,
2055111,2055205,2022-11-30_09-38-34-716562,2055210,94,
2060233,2060268,2022-11-30_09-38-39-917630,2060271,35,
2065359,2065383,2022-11-30_09-38-45-157347,2065386,24,
2070467,2070488,2022-11-30_09-38-50-382583,2070490,21,
2075614,2075719,2022-11-30_09-38-55-712209,2080724,105,
2080737,2080781,2022-11-30_09-39-00-889238,2080784,44,
2085880,2085905,2022-11-30_09-39-06-158730,2085908,25,
2091010,2091030,2022-11-30_09-39-11-397104,2091034,20,
2096125,2096210,2022-11-30_09-39-16-710093,2096214,85,
2101224,2101307,2022-11-30_09-39-21-924778,2101310,83,
2106342,2106378,2022-11-30_09-39-27-116884,2106382,36,
2111460,2111518,2022-11-30_09-39-32-373223,2111524,58,
2116567,2116612,2022-11-30_09-39-37-588468,2116615,45,
2121675,2121707,2022-11-30_09-39-42-802383,2121711,32,
2126774,2126807,2022-11-30_09-39-48-016143,2126810,33,
2131925,2132009,2022-11-30_09-39-53-356107,2132013,84,
2137024,2137048,2022-11-30_09-39-58-514196,2137051,24,
2142168,2142193,2022-11-30_09-40-03-772122,2142196,25,
2147284,2147338,2022-11-30_09-40-09-047656,2147341,54,
2152384,2152404,2022-11-30_09-40-14-233215,2152406,20,
2157500,2157533,2022-11-30_09-40-19-479773,2157535,33,
2162609,2162647,2022-11-30_09-40-24-706683,2162652,38,
2167714,2172814,2022-11-30_09-40-30-027946,2172824,5100,
2172836,2172856,2022-11-30_09-40-35-168086,2172859,20,
2177976,2178046,2022-11-30_09-40-40-476797,2178050,70,
2183083,2183150,2022-11-30_09-40-45-698219,2183156,67,
2188183,2188206,2022-11-30_09-40-50-871586,2188209,23,
2193335,2193363,2022-11-30_09-40-56-146553,2193366,28,
2198441,2198462,2022-11-30_09-41-01-368242,2198465,21,
2203571,2203590,2022-11-30_09-41-06-619838,2203593,19,
2208720,2208766,2022-11-30_09-41-11-919807,2208771,46,
2213826,2213887,2022-11-30_09-41-17-135336,2213892,61,
2218934,2218960,2022-11-30_09-41-22-358204,2218963,26,
2224086,2224106,2022-11-30_09-41-27-627860,2224109,20,
2229202,2229267,2022-11-30_09-41-32-904128,2229270,65,
2234311,2234374,2022-11-30_09-41-38-132967,2234377,63,
2239465,2239484,2022-11-30_09-41-43-365635,2239487,19,
2244594,2244615,2022-11-30_09-41-48-618149,2244617,21,
2249702,2249783,2022-11-30_09-41-53-904109,2249786,81,
2254810,2254829,2022-11-30_09-41-59-076168,2254832,19,
2259927,2259982,2022-11-30_09-42-04-346958,2259986,55,
2265026,2265088,2022-11-30_09-42-09-573420,2265091,62,
2270143,2270198,2022-11-30_09-42-14-800284,2270203,55,
2275252,2275300,2022-11-30_09-42-20-023586,2275305,48,
2280385,0,,2280484,-2280385,
2285501,2285600,2022-11-30_09-42-30-568987,2285606,99,
2290617,2290635,2022-11-30_09-42-35-730588,2290638,18,
2295733,2295795,2022-11-30_09-42-41-007548,2295798,62,
2300841,2300897,2022-11-30_09-42-46-228819,2300900,56,
2305944,2305968,2022-11-30_09-42-51-420531,2305971,24,
2311082,2311102,2022-11-30_09-42-56-683599,2311105,20,
2316248,2316299,2022-11-30_09-43-02-001562,2316302,51,
2321377,2321396,2022-11-30_09-43-07-220009,2321399,19,
2326484,2326513,2022-11-30_09-43-12-455445,2326516,29,
2331615,2331635,2022-11-30_09-43-17-700264,2331639,20,
2336736,2336806,2022-11-30_09-43-22-995738,2336808,70,
2341851,2341871,2022-11-30_09-43-28-181811,2341874,20,
2346996,2347017,2022-11-30_09-43-33-449890,2347020,21,
2352112,0,,2357222,-2352112,
2357234,2357258,2022-11-30_09-43-43-934250,2357261,24,
2362356,2362445,2022-11-30_09-43-49-226260,2362450,89,
2367482,2367524,2022-11-30_09-43-54-438487,2367527,42,
2372609,2372664,2022-11-30_09-43-59-702872,2372667,55,
2377749,2377768,2022-11-30_09-44-04-928144,2377771,19,
2382865,2382930,2022-11-30_09-44-10-212167,2382933,65,
2387982,2388002,2022-11-30_09-44-15-403184,2388005,20,
2393135,2393154,2022-11-30_09-44-20-677247,2393157,19,
2398245,2398267,2022-11-30_09-44-25-907279,2398270,22,
2403376,2403446,2022-11-30_09-44-31-204127,2403448,70,
2408507,2408526,2022-11-30_09-44-36-406776,2408529,19,
2413644,2413663,2022-11-30_09-44-41-664185,2413666,19,
2418750,0,,2418849,-2418750,
2423862,2423881,2022-11-30_09-44-52-126399,2423884,19,
2428986,2429070,2022-11-30_09-44-57-431910,2429075,84,
2434110,2434174,2022-11-30_09-45-02-654826,2434179,64,
2439248,2439269,2022-11-30_09-45-07-881416,2439272,21,
2444391,2444466,2022-11-30_09-45-13-193477,2444469,75,
2449515,2449536,2022-11-30_09-45-18-385755,2449539,21,
2454646,2454674,2022-11-30_09-45-23-648588,2454679,28,
2459777,2459798,2022-11-30_09-45-28-893880,2459801,21,
2464915,2464990,2022-11-30_09-45-34-198359,2464995,75,
2470022,2470043,2022-11-30_09-45-39-371630,2470046,21,
2475151,2475201,2022-11-30_09-45-44-650488,2475206,50,
2480258,2480293,2022-11-30_09-45-49-863343,2480298,35,
2485392,2485415,2022-11-30_09-45-55-113550,2485418,23,
2490510,2490530,2022-11-30_09-46-00-341986,2490533,20,
2495637,2495710,2022-11-30_09-46-05-640113,2495715,73,
2500766,2500812,2022-11-30_09-46-10-860938,2500817,46,
2505893,2505914,2022-11-30_09-46-16-088589,2505917,21,
2511019,2511039,2022-11-30_09-46-21-324389,2511041,20,
2516127,2516221,2022-11-30_09-46-26-635677,2516226,94,
2521291,2521310,2022-11-30_09-46-31-848151,2521312,19,
2526435,2526511,2022-11-30_09-46-37-170284,2526515,76,
2531533,2531556,2022-11-30_09-46-42-334969,2531561,23,
2536650,2536713,2022-11-30_09-46-47-617141,2536717,63,
2541757,2541821,2022-11-30_09-46-52-847910,2541824,64,
2546867,2546937,2022-11-30_09-46-58-074718,2546943,70,
2551972,2552034,2022-11-30_09-47-03-299407,2552039,62,
2557109,2557137,2022-11-30_09-47-08-522740,2557142,28,
2562214,2562265,2022-11-30_09-47-13-770570,2562268,51,
2567320,2567340,2022-11-30_09-47-18-973934,2567343,20,
2572447,2572468,2022-11-30_09-47-24-218812,2572471,21,
2577548,2577645,2022-11-30_09-47-29-512615,2577648,97,
2582678,2582698,2022-11-30_09-47-34-687736,2582700,20,
2587823,2587844,2022-11-30_09-47-39-954079,2587847,21,
2592936,2592957,2022-11-30_09-47-45-183272,2592960,21,
2598039,2598059,2022-11-30_09-47-50-409950,2598062,20,
2603210,2603295,2022-11-30_09-47-55-746377,2603297,85,
2608339,2608359,2022-11-30_09-48-00-954075,2608363,20,
2613445,2613472,2022-11-30_09-48-06-179788,2613475,27,
2618577,2618599,2022-11-30_09-48-11-430498,2618602,22,
2623694,2623781,2022-11-30_09-48-16-725690,2623786,87,
2628792,2628812,2022-11-30_09-48-21-889490,2628815,20,
2633918,2633939,2022-11-30_09-48-27-130507,2633941,21,
2639034,2639092,2022-11-30_09-48-32-401880,2639096,58,
2644133,2644154,2022-11-30_09-48-37-598484,2644157,21,
2649271,2649290,2022-11-30_09-48-42-853606,2649293,19,
2654429,2654522,2022-11-30_09-48-48-206699,2654525,93,
2659549,2659604,2022-11-30_09-48-53-393425,2659609,55,
2664681,2664721,2022-11-30_09-48-58-635582,2664724,40,
2669789,2669900,2022-11-30_09-49-03-937634,2674930,111,
2674951,2674978,2022-11-30_09-49-09-151291,2674981,27,
2680044,2680087,2022-11-30_09-49-14-375069,2680089,43,
2685151,2685194,2022-11-30_09-49-19-608631,2685197,43,
2690259,2690300,2022-11-30_09-49-24-828104,2690303,41,
2695395,2695416,2022-11-30_09-49-30-070886,2695419,21,
2700510,2700608,2022-11-30_09-49-35-376704,2700611,98,
2705626,2705677,2022-11-30_09-49-40-534419,2705680,51,
2710742,2710808,2022-11-30_09-49-45-815228,2710811,66,
2715842,2715862,2022-11-30_09-49-50-991946,2715864,20,
2720997,2721027,2022-11-30_09-49-56-276556,2721030,30,
2726139,2726158,2022-11-30_09-50-01-535976,2726161,19,
2731255,2731318,2022-11-30_09-50-06-817187,2731321,63,
2736375,2736416,2022-11-30_09-50-12-033275,2736419,41,
2741491,2741519,2022-11-30_09-50-17-262847,2741524,28,
2746615,2746648,2022-11-30_09-50-22-502940,2746651,33,
2751733,2751753,2022-11-30_09-50-27-746014,2751756,20,
2756850,2756934,2022-11-30_09-50-33-042932,2756938,84,
2761955,2762026,2022-11-30_09-50-38-233237,2762029,71,
2767101,2767134,2022-11-30_09-50-43-483006,2767138,33,
2772201,2772222,2022-11-30_09-50-48-690000,2772224,21,
2777317,2777442,2022-11-30_09-50-54-030969,2782417,125,
2782429,2782452,2022-11-30_09-50-59-167427,2782455,23,
2787548,2787574,2022-11-30_09-51-04-409171,2787577,26,
2792666,2792768,2022-11-30_09-51-09-709200,2792773,102,
2797777,2797796,2022-11-30_09-51-14-865724,2797799,19,
2802893,2802959,2022-11-30_09-51-20-156357,2802962,66,
2808008,2808037,2022-11-30_09-51-25-340132,2808041,29,
2813131,2813151,2022-11-30_09-51-30-585335,2813154,20,
2818255,2818273,2022-11-30_09-51-35-832164,2818276,18,
2823389,2823409,2022-11-30_09-51-41-085151,2823413,20,
2828510,2828571,2022-11-30_09-51-46-365515,2828576,61,
2833627,2833647,2022-11-30_09-51-51-572999,2833650,20,
2838769,2838851,2022-11-30_09-51-56-901286,2838855,82,
2843899,2843977,2022-11-30_09-52-02-136981,2843983,78,
2849027,2849078,2022-11-30_09-52-07-365994,2849083,51,
2854154,2854174,2022-11-30_09-52-12-581177,2854178,20,
2859266,2859287,2022-11-30_09-52-17-817514,2859358,21,
2864377,2864467,2022-11-30_09-52-23-121004,2864470,90,
2869501,2869522,2022-11-30_09-52-28-292637,2869525,21,
2874608,2874630,2022-11-30_09-52-33-521947,2874633,22,
2879726,2879782,2022-11-30_09-52-38-795122,2879785,56,
2884841,2884884,2022-11-30_09-52-44-023747,2884890,43,
2889980,2895098,2022-11-30_09-52-49-391145,2895103,5118,
2895104,2895194,2022-11-30_09-52-54-571911,2895196,90,
2900215,2900238,2022-11-30_09-52-59-736316,2900241,23,
2905322,2905343,2022-11-30_09-53-04-956766,2905345,21,
2910440,2910500,2022-11-30_09-53-10-235747,2910503,60,
2915576,2915604,2022-11-30_09-53-15-462181,2915607,28,
2920733,2920803,2022-11-30_09-53-20-781836,2920806,70,
2925857,2925910,2022-11-30_09-53-26-013199,2925915,53,
2930978,2931024,2022-11-30_09-53-31-238814,2931029,46,
2936111,2936138,2022-11-30_09-53-36-475066,2936142,27,
2941255,2941332,2022-11-30_09-53-41-785745,2941338,77,
2946376,2946426,2022-11-30_09-53-47-008183,2946431,50,
2951489,2951535,2022-11-30_09-53-52-234837,2951540,46,
2956589,2956611,2022-11-30_09-53-57-442378,2956615,22,
2961731,2961786,2022-11-30_09-54-02-716338,2961789,55,
2966848,2966916,2022-11-30_09-54-07-991674,2966919,68,
2971949,2972029,2022-11-30_09-54-13-223648,2972032,80,
2977105,2977129,2022-11-30_09-54-18-446204,2977132,24,
2982241,2982262,2022-11-30_09-54-23-701750,2982265,21,
2987359,2987416,2022-11-30_09-54-28-987481,2987419,57,
2992457,2992479,2022-11-30_09-54-34-164657,2992482,22,
2997606,2997626,2022-11-30_09-54-39-435680,2997629,20,
3002713,3007840,2022-11-30_09-54-44-766078,3007856,5127,
3007877,3007927,2022-11-30_09-54-49-981803,3007930,50,
3012954,3012975,2022-11-30_09-54-55-142851,3012978,21,
3018088,3018109,2022-11-30_09-55-00-397526,3018112,21,
3023202,3023256,2022-11-30_09-55-05-661768,3023261,54,
3028303,3028369,2022-11-30_09-55-10-898535,3028372,66,
3033420,3033455,2022-11-30_09-55-16-104322,3033460,35,
3038520,3038607,2022-11-30_09-55-21-375943,3038610,87,
3043629,3043650,2022-11-30_09-55-26-542518,3043653,21,
3048767,3048856,2022-11-30_09-55-31-868664,3048859,89,
3053893,3053978,2022-11-30_09-55-37-101020,3053983,85,
3058999,3059021,2022-11-30_09-55-42-267953,3059024,22,
3064106,3064176,2022-11-30_09-55-47-544854,3064179,70,
3069224,3069276,2022-11-30_09-55-52-771272,3069281,52,
3074327,3074386,2022-11-30_09-55-57-992800,3074391,59,
3079442,3079486,2022-11-30_09-56-03-218073,3079491,44,
3084573,3084606,2022-11-30_09-56-08-447753,3084611,33,
3089685,0,,3094804,-3089685,
3094824,3094878,2022-11-30_09-56-18-977711,3094882,54,
3099908,3099928,2022-11-30_09-56-24-144135,3099931,20,
3105038,3105058,2022-11-30_09-56-29-399055,3105062,20,
3110151,3110190,2022-11-30_09-56-34-654695,3110193,39,
3115332,3115397,2022-11-30_09-56-39-980555,3115403,65,
3120430,3120459,2022-11-30_09-56-45-161498,3120463,29,
3125547,3125596,2022-11-30_09-56-50-426518,3125600,49,
3130646,3130666,2022-11-30_09-56-55-614879,3130669,20,
3135764,3135796,2022-11-30_09-57-00-867169,3135799,32,
3140872,3140903,2022-11-30_09-57-06-095916,3140908,31,
3145978,3146006,2022-11-30_09-57-11-303928,3146009,28,
3151087,3151112,2022-11-30_09-57-16-540967,3151117,25,
3156204,3156224,2022-11-30_09-57-21-773189,3156227,20,
3161347,3161431,2022-11-30_09-57-27-096581,3161436,84,
3166475,3171606,2022-11-30_09-57-32-432004,3171609,5131,
3171610,3171673,2022-11-30_09-57-37-587408,3171676,63,
3176744,3176767,2022-11-30_09-57-42-804971,3176769,23,
3181865,3181950,2022-11-30_09-57-48-104527,3181953,85,
3186973,3187028,2022-11-30_09-57-53-300958,3187031,55,
3192117,3192143,2022-11-30_09-57-58-541145,3192146,26,
3197224,3197277,2022-11-30_09-58-03-786534,3197281,53,
3202348,3202371,2022-11-30_09-58-09-012519,3202374,23,
3207466,3207486,2022-11-30_09-58-14-245413,3207490,20,
3212573,3212592,2022-11-30_09-58-19-469669,3212595,19,
3217709,3217747,2022-11-30_09-58-24-744205,3217750,38,
3222818,3227920,2022-11-30_09-58-29-978443,3227933,5102,
3227946,3227967,2022-11-30_09-58-35-201952,3227969,21,
3233054,3233075,2022-11-30_09-58-40-439392,3233077,21,
3238185,3238205,2022-11-30_09-58-45-693750,3238208,20,
3243306,3243354,2022-11-30_09-58-50-961610,3243358,48,
3248433,3248478,2022-11-30_09-58-56-202742,3248480,45,
3253564,3253586,2022-11-30_09-59-01-438759,3253589,22,
3258673,3258695,2022-11-30_09-59-06-671428,3258698,22,
3263798,3263862,2022-11-30_09-59-11-964171,3263867,64,
3268909,3268928,2022-11-30_09-59-17-150747,3268930,19,
3274045,3274065,2022-11-30_09-59-22-407112,3274068,20,
3279200,3279257,2022-11-30_09-59-27-725169,3279260,57,
3284338,3284369,2022-11-30_09-59-32-955064,3284372,31,
3289465,3289497,2022-11-30_09-59-38-190995,3289503,32,
3294570,3294591,2022-11-30_09-59-43-424784,3294594,21,
3299689,3299758,2022-11-30_09-59-48-711648,3299761,69,
3304808,3304840,2022-11-30_09-59-53-912133,3304843,32,
3309945,3309972,2022-11-30_09-59-59-167086,3309975,27,
3315079,3315098,2022-11-30_10-00-04-407018,3315101,19,
3320188,3320210,2022-11-30_10-00-09-644852,3320213,22,
3325322,3325343,2022-11-30_10-00-14-902964,3325346,21,
3330429,3330449,2022-11-30_10-00-20-130031,3330452,20,
3335561,3335581,2022-11-30_10-00-25-384725,3335585,20,
3340678,3340711,2022-11-30_10-00-30-623137,3340714,33,
3345800,3345820,2022-11-30_10-00-35-859659,3345823,20,
3350905,3350925,2022-11-30_10-00-41-080360,3350928,20,
3356012,3356035,2022-11-30_10-00-46-311488,3356038,23,
3361130,3361199,2022-11-30_10-00-51-601183,3361202,69,
3366231,3366312,2022-11-30_10-00-56-831642,3366315,81,
3371345,3371414,2022-11-30_10-01-02-056104,3371420,69,
3376451,3376528,2022-11-30_10-01-07-277549,3376531,77,
3381562,3381633,2022-11-30_10-01-12-505017,3381638,71,
3386668,3386728,2022-11-30_10-01-17-724073,3386731,60,
3391773,3391827,2022-11-30_10-01-22-947472,3391829,54,
3396885,3396933,2022-11-30_10-01-28-171138,3396938,48,
3401994,3402029,2022-11-30_10-01-33-393455,3402035,35,
3407101,3407147,2022-11-30_10-01-38-620887,3407152,46,
3412210,3412250,2022-11-30_10-01-43-845236,3412255,40,
3417315,3417335,2022-11-30_10-01-49-057726,3417338,20,
3422456,3422476,2022-11-30_10-01-54-323727,3422479,20,
3427570,3427641,2022-11-30_10-01-59-610932,3427643,71,
3432682,3432743,2022-11-30_10-02-04-837965,3432749,61,
3437784,3437805,2022-11-30_10-02-10-017760,3437808,21,
3442919,3442945,2022-11-30_10-02-15-280212,3442948,26,
3448039,3448059,2022-11-30_10-02-20-518399,3448062,20,
3453161,3453182,2022-11-30_10-02-25-766310,3453185,21,
3458268,3458289,2022-11-30_10-02-30-991193,3458292,21,
3463422,3463450,2022-11-30_10-02-36-274183,3463452,28,
3468521,3468542,2022-11-30_10-02-41-485035,3468546,21,
3473658,3473678,2022-11-30_10-02-46-740776,3473681,20,
3478759,3478854,2022-11-30_10-02-52-038284,3478857,95,
3483868,3483890,2022-11-30_10-02-57-190701,3483893,22,
3488981,3489002,2022-11-30_10-03-02-428033,3489005,21,
3494134,3494179,2022-11-30_10-03-07-719573,3494184,45,
3499240,3499275,2022-11-30_10-03-12-939432,3499281,35,
3504340,3504380,2022-11-30_10-03-18-161495,3504383,40,
3509456,3509484,2022-11-30_10-03-23-386064,3509490,28,
3514564,3514588,2022-11-30_10-03-28-611294,3514590,24,
3519693,3519718,2022-11-30_10-03-33-860461,3519721,25,
3524807,3524908,2022-11-30_10-03-39-147938,3524910,101,
3529936,3530010,2022-11-30_10-03-44-391979,3530015,74,
3535037,3540146,2022-11-30_10-03-49-605960,3540162,5109,
3540177,3545254,2022-11-30_10-03-54-924531,3545266,5077,
3545278,3545301,2022-11-30_10-04-00-058493,3545304,23,
3550368,3550397,2022-11-30_10-04-05-262485,3550400,29,
3555475,3555503,2022-11-30_10-04-10-495289,3555507,28,
3560616,3560684,2022-11-30_10-04-15-812081,3560687,68,
3565754,3565861,2022-11-30_10-04-21-095124,3570847,107,
3570866,3570903,2022-11-30_10-04-26-266546,3570907,37,
3575995,3576026,2022-11-30_10-04-31-501402,3576032,31,
3581114,3581135,2022-11-30_10-04-36-748111,3581138,21,
3586237,3586313,2022-11-30_10-04-42-039900,3586318,76,
3591356,3591377,2022-11-30_10-04-47-229658,3591380,21,
3596487,3596514,2022-11-30_10-04-52-480472,3596516,27,
3601593,3601621,2022-11-30_10-04-57-706305,3601627,28,
3606712,3606744,2022-11-30_10-05-02-942462,3606750,32,
3611865,3611930,2022-11-30_10-05-08-251058,3611933,65,
3616997,3617032,2022-11-30_10-05-13-481176,3617038,35,
3622119,3622139,2022-11-30_10-05-18-705752,3622141,20,
3627251,3627271,2022-11-30_10-05-23-971269,3627274,20,
3632371,3632439,2022-11-30_10-05-29-253877,3632442,68,
3637502,3637527,2022-11-30_10-05-34-466947,3637530,25,
3642619,3642640,2022-11-30_10-05-39-702461,3642643,21,
3647733,3647752,2022-11-30_10-05-44-938571,3647756,19,
3652840,3652863,2022-11-30_10-05-50-168671,3652866,23,
3657952,3657972,2022-11-30_10-05-55-398946,3657975,20,
3663077,3663160,2022-11-30_10-06-00-709220,3663163,83,
3668191,3668221,2022-11-30_10-06-05-889117,3668224,30,
3673325,3673346,2022-11-30_10-06-11-137281,3673350,21,
3678438,3678565,2022-11-30_10-06-16-459365,3683578,127,
3683598,3683665,2022-11-30_10-06-21-689453,3683670,67,
3688692,3688714,2022-11-30_10-06-26-865606,3688717,22,
3693808,3693872,2022-11-30_10-06-32-128766,3693877,64,
3698941,3698961,2022-11-30_10-06-37-348541,3698965,20,
3704060,3704080,2022-11-30_10-06-42-592130,3704082,20,
3709169,3709188,2022-11-30_10-06-47-827007,3709192,19,
3714283,3714361,2022-11-30_10-06-53-118794,3714363,78,
3719430,3719473,2022-11-30_10-06-58-352419,3719476,43,
3724559,3724578,2022-11-30_10-07-03-583744,3724581,19,
3729679,3729698,2022-11-30_10-07-08-823689,3729701,19,
3734804,3734876,2022-11-30_10-07-14-124588,3734879,72,
3739912,3739934,2022-11-30_10-07-19-300564,3739937,22,
3745036,3745092,2022-11-30_10-07-24-571033,3745097,56,
3750144,3750182,2022-11-30_10-07-29-790036,3750185,38,
3755263,3755286,2022-11-30_10-07-35-009630,3755289,23,
3760390,3760411,2022-11-30_10-07-40-261870,3760415,21,
3765507,3765526,2022-11-30_10-07-45-489294,3765529,19,
3770631,3770707,2022-11-30_10-07-50-790777,3770712,76,
3775764,3775786,2022-11-30_10-07-56-002126,3775789,22,
3780869,3780892,2022-11-30_10-08-01-223945,3780894,23,
3785993,3786015,2022-11-30_10-08-06-473058,3786019,22,
3791169,3791199,2022-11-30_10-08-11-781433,3791204,30,
3796319,3796406,2022-11-30_10-08-17-110316,3796409,87,
3801419,3801440,2022-11-30_10-08-22-261313,3801443,21,
3806533,3806603,2022-11-30_10-08-27-550558,3806606,70,
3811642,3811714,2022-11-30_10-08-32-773587,3811717,72,
3816750,3816770,2022-11-30_10-08-37-948701,3816773,20,
3821865,3821915,2022-11-30_10-08-43-220147,3821917,50,
3826974,3827016,2022-11-30_10-08-48-444298,3827022,42,
3832082,3832130,2022-11-30_10-08-53-669807,3832136,48,
3837191,3837236,2022-11-30_10-08-58-894132,3837241,45,
3842297,3842320,2022-11-30_10-09-04-112415,3842323,23,
3847433,3847454,2022-11-30_10-09-09-367562,3847456,21,
3852546,3852619,2022-11-30_10-09-14-660664,3852622,73,
3857684,3857733,2022-11-30_10-09-19-885207,3857737,49,
3862790,3862855,2022-11-30_10-09-25-133734,3862859,65,
3867899,3867934,2022-11-30_10-09-30-334026,3867937,35,
3872992,3873054,2022-11-30_10-09-35-557157,3873060,62,
3878116,3878139,2022-11-30_10-09-40-777320,3878143,23,
3883220,3883250,2022-11-30_10-09-45-994377,3883252,30,
3888369,3888459,2022-11-30_10-09-51-328808,3888464,90,
3893509,3893547,2022-11-30_10-09-56-547574,3893552,38,
3898617,3898644,2022-11-30_10-10-01-763692,3898647,27,
3903761,3903854,2022-11-30_10-10-07-086342,3903857,93,
3908854,3908907,2022-11-30_10-10-12-273131,3908910,53,
3913981,3914053,2022-11-30_10-10-17-542382,3914059,72,
3919079,3919157,2022-11-30_10-10-22-765154,3919159,78,
3924196,3924270,2022-11-30_10-10-27-992190,3924275,74,
3929305,3929383,2022-11-30_10-10-33-222191,3929388,78,
3934404,3934483,2022-11-30_10-10-38-434590,3934485,79,
3939520,3939580,2022-11-30_10-10-43-664334,3939586,60,
3944628,3944680,2022-11-30_10-10-48-890100,3944683,52,
3949737,3949793,2022-11-30_10-10-54-108282,3949798,56,
3954835,3954874,2022-11-30_10-10-59-326702,3954877,39,
3959969,3959999,2022-11-30_10-11-04-560806,3960004,30,
3965114,3965136,2022-11-30_10-11-09-831660,3965139,22,
3970221,3970245,2022-11-30_10-11-15-060558,3970248,24,
3975337,3975382,2022-11-30_10-11-20-318177,3975385,45,
3980440,3980485,2022-11-30_10-11-25-541188,3980488,45,
3985588,3985619,2022-11-30_10-11-30-802164,3985623,31,
3990695,3990715,2022-11-30_10-11-36-020573,3990719,20,
3995804,3995822,2022-11-30_10-11-41-242265,3995825,18,
4000925,4001004,2022-11-30_10-11-46-542709,4001007,79,
4006054,4006126,2022-11-30_10-11-51-773024,4006132,72,
4011168,4011187,2022-11-30_10-11-56-970144,4011190,19,
4016298,4016318,2022-11-30_10-12-02-213789,4016321,20,
4021445,4021501,2022-11-30_10-12-07-525479,4021505,56,
4026571,4026623,2022-11-30_10-12-12-760972,4026628,52,
4031678,4031723,2022-11-30_10-12-17-984707,4031729,45,
4036811,4036834,2022-11-30_10-12-23-218651,4036837,23,
4041943,4042023,2022-11-30_10-12-28-531792,4042028,80,
4047087,4047115,2022-11-30_10-12-33-752203,4047119,28,
4052215,4052317,2022-11-30_10-12-39-073843,4052319,102,
4057336,4057431,2022-11-30_10-12-44-312745,4057434,95,
4062462,4062532,2022-11-30_10-12-49-528620,4062535,70,
4067570,4067625,2022-11-30_10-12-54-746564,4067629,55,
4072708,4072728,2022-11-30_10-12-59-971356,4072731,20,
4077855,4077947,2022-11-30_10-13-05-302558,4077952,92,
4082982,4083002,2022-11-30_10-13-10-480384,4083006,20,
4088110,4088143,2022-11-30_10-13-15-743482,4088148,33,
4093240,4093262,2022-11-30_10-13-20-982329,4093266,22,
4098458,4103569,2022-11-30_10-13-26-424598,4103584,5111,
4103605,4103647,2022-11-30_10-13-31-608520,4103649,42,
4108693,4108713,2022-11-30_10-13-36-802700,4108716,20,
4113801,4113825,2022-11-30_10-13-42-032604,4113828,24,
4118909,4118938,2022-11-30_10-13-47-258392,4118941,29,
4124052,4124073,2022-11-30_10-13-52-535889,4124076,21,
4129168,4129187,2022-11-30_10-13-57-761706,4129190,19,
4134287,4134361,2022-11-30_10-14-03-058877,4134367,74,
4139411,4139468,2022-11-30_10-14-08-285041,4139473,57,
4144523,4149619,2022-11-30_10-14-13-630959,4149622,5096,
4149622,4149642,2022-11-30_10-14-18-705631,4149646,20,
4154747,4154789,2022-11-30_10-14-23-970868,4154792,42,
4159865,4159911,2022-11-30_10-14-29-214080,4159915,46,
4164983,4165003,2022-11-30_10-14-34-427085,4165006,20,
4170105,4170175,2022-11-30_10-14-39-721012,4170181,70,
4175221,4175243,2022-11-30_10-14-44-906438,4175246,22,
4180378,4180400,2022-11-30_10-14-50-186870,4180403,22,
4185491,4185569,2022-11-30_10-14-55-479685,4185572,78,
4190614,4190688,2022-11-30_10-15-00-716961,4190693,74,
4195715,4195788,2022-11-30_10-15-05-936570,4195792,73,
4200829,4200894,2022-11-30_10-15-11-160036,4200897,65,
4205951,4205987,2022-11-30_10-15-16-377387,4205990,36,
4211059,4216169,2022-11-30_10-15-21-812053,4216172,5110,
4216173,4216197,2022-11-30_10-15-26-835821,4216200,24,
4221276,4221296,2022-11-30_10-15-32-056850,4221300,20,
4226417,4226437,2022-11-30_10-15-37-317554,4226440,20,
4231550,4231596,2022-11-30_10-15-42-600099,4231599,46,
4236659,4236731,2022-11-30_10-15-47-837034,4236734,72,
4241767,4241792,2022-11-30_10-15-53-036455,4241795,25,
4246904,4246923,2022-11-30_10-15-58-291143,4246926,19,
4252012,4252033,2022-11-30_10-16-03-524982,4252036,21,
4257138,4257158,2022-11-30_10-16-08-770213,4257161,20,
4262254,4262312,2022-11-30_10-16-14-040763,4262315,58,
4267364,4267411,2022-11-30_10-16-19-265228,4267416,47,
4272470,4272518,2022-11-30_10-16-24-487551,4272520,48,
4277616,4277713,2022-11-30_10-16-29-805445,4277716,97,
4282733,4282753,2022-11-30_10-16-34-965773,4282755,20,
4287841,0,,4292945,-4287841,
4292958,4292977,2022-11-30_10-16-45-430378,4292980,19,
4298056,4298135,2022-11-30_10-16-50-705560,4298140,79,
4303165,4303185,2022-11-30_10-16-55-884447,4303188,20,
4308281,4308340,2022-11-30_10-17-01-152052,4308343,59,
4313425,4313445,2022-11-30_10-17-06-383836,4313448,20,
4318530,4318551,2022-11-30_10-17-11-618529,4318555,21,
4323672,4323742,2022-11-30_10-17-16-926409,4323745,70,
4328779,4328851,2022-11-30_10-17-22-148265,4328856,72,
4333887,4333941,2022-11-30_10-17-27-371054,4333944,54,
4338994,4339059,2022-11-30_10-17-32-602787,4339065,65,
4344103,4344150,2022-11-30_10-17-37-817100,4344153,47,
4349218,4349250,2022-11-30_10-17-43-038118,4349256,32,
4354325,4354359,2022-11-30_10-17-48-266685,4354362,34,
4359433,4359460,2022-11-30_10-17-53-487830,4359463,27,
4364534,4364555,2022-11-30_10-17-58-707507,4364558,21,
4369672,4369693,2022-11-30_10-18-03-963025,4369696,21,
4374789,4374860,2022-11-30_10-18-09-251758,4374863,71,
4379897,4379969,2022-11-30_10-18-14-484648,4379975,72,
4384995,4385016,2022-11-30_10-18-19-650429,4385019,21,
4390112,4390159,2022-11-30_10-18-24-917765,4390162,47,
4395220,4395278,2022-11-30_10-18-30-142453,4395281,58,
4400319,4405458,2022-11-30_10-18-35-518218,4405461,5139,
4405461,4405482,2022-11-30_10-18-40-596868,4405484,21,
4410587,4410683,2022-11-30_10-18-45-914759,4410686,96,
4415689,4415709,2022-11-30_10-18-51-069155,4415712,20,
4420813,4420834,2022-11-30_10-18-56-306742,4420837,21,
4425933,4426019,2022-11-30_10-19-01-601731,4426023,86,
4431062,4431081,2022-11-30_10-19-06-807342,4431085,19,
4436191,4436286,2022-11-30_10-19-12-130269,4436291,95,
4441315,4441335,2022-11-30_10-19-17-304042,4441338,20,
4446423,4446443,2022-11-30_10-19-22-540259,4446447,20,
4451541,4451596,2022-11-30_10-19-27-806772,4451599,55,
4456670,4456698,2022-11-30_10-19-33-031051,4456701,28,
4461797,4461893,2022-11-30_10-19-38-347136,4461896,96,
4466905,4466925,2022-11-30_10-19-43-494609,4466929,20,
4472019,4472038,2022-11-30_10-19-48-729187,4472041,19,
4477146,4477215,2022-11-30_10-19-54-030066,4477221,69,
4482275,4482321,2022-11-30_10-19-59-252550,4482327,46,
4487407,4492515,2022-11-30_10-20-04-624582,4492519,5108,
4492520,4492541,2022-11-30_10-20-09-719098,4492545,21,
4497644,4497736,2022-11-30_10-20-15-024106,4497741,92,
4502768,4502829,2022-11-30_10-20-20-245249,4502835,61,
4507900,4507933,2022-11-30_10-20-25-466787,4507939,33,
4513029,4513049,2022-11-30_10-20-30-710480,4513052,20,
4518188,4518232,2022-11-30_10-20-36-015131,4518235,44,
4523329,0,,4523428,-4523329,
4528458,4528479,2022-11-30_10-20-46-507677,4528482,21,
4533578,4533651,2022-11-30_10-20-51-788295,4533656,73,
4538709,4538733,2022-11-30_10-20-57-002073,4538736,24,
4543833,0,,4543933,-4543833,
4548957,4548978,2022-11-30_10-21-07-488892,4548981,21,
4554116,4554161,2022-11-30_10-21-12-785275,4554166,45,
4559259,4559279,2022-11-30_10-21-18-035348,4559282,20,
4564369,4564464,2022-11-30_10-21-23-330577,4564468,95,
4569475,4569495,2022-11-30_10-21-28-495762,4569497,20,
4574596,4574659,2022-11-30_10-21-33-777071,4574663,63,
4579731,4579770,2022-11-30_10-21-39-003363,4579775,39,
4584855,4584876,2022-11-30_10-21-44-237361,4584879,21,
4589980,4589999,2022-11-30_10-21-49-481417,4590002,19,
4595083,4595167,2022-11-30_10-21-54-769374,4595170,84,
4600200,4600265,2022-11-30_10-21-59-985493,4600268,65,
4605305,4605377,2022-11-30_10-22-05-212210,4605383,72,
4610436,4610469,2022-11-30_10-22-10-433256,4610472,33,
4615544,4615591,2022-11-30_10-22-15-662212,4615596,47,
4620651,4620677,2022-11-30_10-22-20-879319,4620679,26,
4625777,4625799,2022-11-30_10-22-26-123999,4625801,22,
4630894,4630915,2022-11-30_10-22-31-360990,4630919,21,
4636044,4636064,2022-11-30_10-22-36-640596,4636067,20,
4641161,4641185,2022-11-30_10-22-41-881845,4641188,24,
4646268,4646297,2022-11-30_10-22-47-106553,4646302,29,
4651433,4651504,2022-11-30_10-22-52-421223,4651507,71,
4656535,4656554,2022-11-30_10-22-57-613061,4656558,19,
4661652,4661711,2022-11-30_10-23-02-894578,4661715,59,
4666759,4666806,2022-11-30_10-23-08-098878,4666811,47,
4671867,4671899,2022-11-30_10-23-13-310887,4671902,32,
4677007,4677027,2022-11-30_10-23-18-573238,4677030,20,
4682105,4682125,2022-11-30_10-23-23-783930,4682129,20,
4687264,4687314,2022-11-30_10-23-29-087207,4687317,50,
4692370,4692422,2022-11-30_10-23-34-315328,4692428,52,
4697499,4697518,2022-11-30_10-23-39-541561,4697521,19,
4702654,4702674,2022-11-30_10-23-44-827188,4702677,20,
4707770,4707811,2022-11-30_10-23-50-085985,4707813,41,
4712879,4712910,2022-11-30_10-23-55-301063,4712913,31,
4717986,4718023,2022-11-30_10-24-00-536192,4718029,37,
4723094,4723119,2022-11-30_10-24-05-757051,4723123,25,
4728236,4728255,2022-11-30_10-24-11-011795,4728258,19,
4733349,4733421,2022-11-30_10-24-16-303571,4733424,72,
4738452,4738472,2022-11-30_10-24-21-468212,4738475,20,
4743611,4743629,2022-11-30_10-24-26-753955,4743632,18,
4748771,4748838,2022-11-30_10-24-32-078215,4748843,67,
4753879,4753936,2022-11-30_10-24-37-289775,4753939,57,
4758986,4759044,2022-11-30_10-24-42-521918,4759049,58,
4764095,4764141,2022-11-30_10-24-47-747270,4764145,46,
4769202,4769261,2022-11-30_10-24-52-990177,4769264,59,
4774310,4774343,2022-11-30_10-24-58-196709,4774349,33,
4779419,4779448,2022-11-30_10-25-03-410368,4779453,29,
4784520,4784558,2022-11-30_10-25-08-642915,4784564,38,
4789628,4789661,2022-11-30_10-25-13-865552,4789664,33,
4794779,4794840,2022-11-30_10-25-19-178083,4794843,61,
4799887,4799943,2022-11-30_10-25-24-401032,4799945,56,
4804985,4805030,2022-11-30_10-25-29-605105,4805033,45,
4810093,4810113,2022-11-30_10-25-34-805393,4810116,20,
4815226,4815266,2022-11-30_10-25-40-063029,4815269,40,
4820355,4820375,2022-11-30_10-25-45-305685,4820378,20,
4825483,4825505,2022-11-30_10-25-50-561495,4825509,22,
4830604,4830623,2022-11-30_10-25-55-804875,4830626,19,
4835719,4835762,2022-11-30_10-26-01-064941,4835766,43,
4840845,4840892,2022-11-30_10-26-06-311596,4840895,47,
4845961,4845982,2022-11-30_10-26-11-524818,4845984,21,
4851110,4851188,2022-11-30_10-26-16-850246,4851193,78,
4856237,4856285,2022-11-30_10-26-22-069106,4856290,48,
4861370,4861397,2022-11-30_10-26-27-306854,4861400,27,
4866505,4866526,2022-11-30_10-26-32-551222,4866529,21,
4871623,4871680,2022-11-30_10-26-37-828832,4871684,57,
4876747,4876784,2022-11-30_10-26-43-056197,4876787,37,
4881877,4881899,2022-11-30_10-26-48-287904,4881904,22,
4887014,4887033,2022-11-30_10-26-53-542804,4887037,19,
4892125,4892144,2022-11-30_10-26-58-777715,4892147,19,
4897233,4897252,2022-11-30_10-27-04-010152,4897255,19,
4902366,4902403,2022-11-30_10-27-09-275941,4902406,37,
4907474,4907497,2022-11-30_10-27-14-504132,4907499,23,
4912597,4912619,2022-11-30_10-27-19-739441,4912622,22,
4917711,4917731,2022-11-30_10-27-24-972603,4917735,20,
4922831,4922902,2022-11-30_10-27-30-266337,4922904,71,
4927962,4927982,2022-11-30_10-27-35-470907,4927985,20,
4933077,4933125,2022-11-30_10-27-40-724969,4933127,48,
4938213,4938234,2022-11-30_10-27-45-957061,4938304,21,
4943320,4943339,2022-11-30_10-27-51-187496,4943342,19,
4948432,4948451,2022-11-30_10-27-56-415971,4948455,19,
4953550,4953638,2022-11-30_10-28-01-717837,4953643,88,
4958673,4958726,2022-11-30_10-28-06-939692,4958729,53,
4963810,4963829,2022-11-30_10-28-12-160538,4963832,19,
4968910,4968930,2022-11-30_10-28-17-385047,4968933,20,
4974163,4974232,2022-11-30_10-28-22-812600,4974234,69,
4979287,4979342,2022-11-30_10-28-28-038133,4979348,55,
4984415,4984436,2022-11-30_10-28-33-257371,4984440,21,
4989537,4989557,2022-11-30_10-28-38-495305,4989561,20,
4994648,4994669,2022-11-30_10-28-43-734585,4994672,21,
4999754,4999774,2022-11-30_10-28-48-950559,4999777,20,
5004900,5004964,2022-11-30_10-28-54-258245,5004969,64,
5010028,5010052,2022-11-30_10-28-59-475111,5010055,24,
5015236,5015258,2022-11-30_10-29-04-801376,5015261,22,
5020344,5020363,2022-11-30_10-29-10-025088,5020366,19,
5025454,5025473,2022-11-30_10-29-15-267032,5025476,19,
5030561,5030659,2022-11-30_10-29-20-564066,5030662,98,
5035692,5035757,2022-11-30_10-29-25-796155,5035760,65,
5040799,5040832,2022-11-30_10-29-30-998067,5040836,33,
5045907,5045963,2022-11-30_10-29-36-238386,5045966,56,
5051035,5051066,2022-11-30_10-29-41-459239,5051068,31,
5056132,5056160,2022-11-30_10-29-46-667856,5056163,28,
5061250,5061272,2022-11-30_10-29-51-911075,5061275,22,
5066358,5066379,2022-11-30_10-29-57-134493,5066382,21,
5071484,5071574,2022-11-30_10-30-02-451190,5071577,90,
5076613,5076692,2022-11-30_10-30-07-687350,5076697,79,
5081713,5081733,2022-11-30_10-30-12-850476,5081737,20,
5086862,5086946,2022-11-30_10-30-18-170670,5086949,84,
5091987,5092006,2022-11-30_10-30-23-374616,5092009,19,
5097129,5097154,2022-11-30_10-30-28-635586,5097158,25,
5102246,5102292,2022-11-30_10-30-33-899960,5102295,46,
5107357,5107388,2022-11-30_10-30-39-124676,5107391,31,
5112464,5112495,2022-11-30_10-30-44-345787,5112501,31,
5117575,5117598,2022-11-30_10-30-49-566104,5117603,23,
5122705,5122723,2022-11-30_10-30-54-816105,5122726,18,
5127812,5127835,2022-11-30_10-31-00-047594,5127838,23,
5132941,5132962,2022-11-30_10-31-05-291547,5132965,21,
5138048,5138069,2022-11-30_10-31-10-521793,5138072,21,
5143191,5143219,2022-11-30_10-31-15-789429,5143224,28,
5148298,5148321,2022-11-30_10-31-21-011608,5148323,23,
5153398,5153417,2022-11-30_10-31-26-233297,5153420,19,
5158529,5158550,2022-11-30_10-31-31-488751,5158552,21,
5163639,5163719,2022-11-30_10-31-36-781602,5163728,80,
5168754,5168840,2022-11-30_10-31-41-997480,5168843,86,
5173866,5173885,2022-11-30_10-31-47-192661,5173888,19,
5178983,5179025,2022-11-30_10-31-52-450994,5179028,42,
5184091,5184130,2022-11-30_10-31-57-675611,5184135,39,
5189220,5189271,2022-11-30_10-32-02-931407,5189274,51,
5194328,5194359,2022-11-30_10-32-08-132292,5194364,31,
5199465,5199485,2022-11-30_10-32-13-391139,5199488,20,
5204574,5204647,2022-11-30_10-32-18-668294,5204650,73,
5209689,5209747,2022-11-30_10-32-23-892657,5209755,58,
5214796,5214852,2022-11-30_10-32-29-114613,5214856,56,
5219904,5219956,2022-11-30_10-32-34-337995,5219959,52,
5225012,5225057,2022-11-30_10-32-39-560771,5225062,45,
5230120,5230159,2022-11-30_10-32-44-784315,5230163,39,
5235219,5235239,2022-11-30_10-32-49-984934,5235242,20,
5240339,5240358,2022-11-30_10-32-55-230387,5240361,19,
5245470,5245489,2022-11-30_10-33-00-479141,5245492,19,
5250599,5250668,2022-11-30_10-33-05-779434,5250670,69,
5255729,5255774,2022-11-30_10-33-11-003622,5255777,45,
5260837,5260869,2022-11-30_10-33-16-223994,5260871,32,
5265961,5265981,2022-11-30_10-33-21-459240,5265985,20,
5271098,5271117,2022-11-30_10-33-26-715413,5271121,19,
5276205,5276226,2022-11-30_10-33-31-942265,5276228,21,
5281325,5281380,2022-11-30_10-33-37-214019,5281383,55,
5286445,5286465,2022-11-30_10-33-42-423487,5286469,20,
5291695,5291794,2022-11-30_10-33-47-871212,5291797,99,
5296833,5296893,2022-11-30_10-33-53-094388,5296896,60,
5301962,5301998,2022-11-30_10-33-58-318316,5302001,36,
5307096,5307116,2022-11-30_10-34-03-560005,5307119,20,
5312209,5312294,2022-11-30_10-34-08-858169,5312304,85,
5317341,5317428,2022-11-30_10-34-14-094110,5317433,87,
5322469,5322517,2022-11-30_10-34-19-315489,5322520,48,
5327575,5327610,2022-11-30_10-34-24-534954,5327615,35,
5332719,5332740,2022-11-30_10-34-29-784765,5332742,21,
5337825,5337846,2022-11-30_10-34-35-019166,5337849,21,
5342949,0,,5348069,-5342949,
5348090,5348130,2022-11-30_10-34-45-540851,5348133,40,
5353178,5353202,2022-11-30_10-34-50-740803,5353204,24,
5358300,5358322,2022-11-30_10-34-55-984202,5358325,22,
5363407,5363428,2022-11-30_10-35-01-207347,5363431,21,
5368532,5368553,2022-11-30_10-35-06-453807,5368556,21,
5373653,5373725,2022-11-30_10-35-11-749353,5373729,72,
5378789,5378824,2022-11-30_10-35-16-963749,5378827,35,
5383926,5384020,2022-11-30_10-35-22-287570,5384023,94,
5389036,5389057,2022-11-30_10-35-27-439260,5389060,21,
5394156,5394240,2022-11-30_10-35-32-742316,5394245,84,
5399255,5399274,2022-11-30_10-35-37-899362,5399277,19,
5404391,5404450,2022-11-30_10-35-43-189861,5404454,59,
5409528,5409548,2022-11-30_10-35-48-410810,5409552,20,
5414650,5414670,2022-11-30_10-35-53-649725,5414673,20,
5419798,5419857,2022-11-30_10-35-58-962038,5419862,59,
5424933,5424952,2022-11-30_10-36-04-182808,5424955,19,
5430059,5430152,2022-11-30_10-36-09-498771,5430155,93,
5435176,5435196,2022-11-30_10-36-14-672766,5435199,20,
5440293,5440362,2022-11-30_10-36-19-954361,5440365,69,
5445400,5445467,2022-11-30_10-36-25-168779,5445470,67,
5450509,5450560,2022-11-30_10-36-30-399282,5450563,51,
5455617,5455682,2022-11-30_10-36-35-632119,5455689,65,
5460724,5460765,2022-11-30_10-36-40-846132,5460770,41,
5465832,5465866,2022-11-30_10-36-46-070596,5465872,34,
5470942,5470976,2022-11-30_10-36-51-292544,5470980,34,
5476048,5476077,2022-11-30_10-36-56-507399,5476081,29,
5481154,5481177,2022-11-30_10-37-01-736223,5481179,23,
5486282,5486303,2022-11-30_10-37-06-982437,5486305,21,
5491399,5491472,2022-11-30_10-37-12-279402,5491474,73,
5496499,5496520,2022-11-30_10-37-17-445356,5496523,21,
5501616,5501638,2022-11-30_10-37-22-683162,5501641,22,
5506733,5506783,2022-11-30_10-37-27-948123,5506786,50,
5511831,5511851,2022-11-30_10-37-33-136034,5511855,20,
5516972,5516992,2022-11-30_10-37-38-394710,5516995,20,
5522070,5522096,2022-11-30_10-37-43-626654,5522099,26,
5527207,5527227,2022-11-30_10-37-48-872841,5527230,20,
5532369,5532394,2022-11-30_10-37-54-165717,5532397,25,
5537476,5537499,2022-11-30_10-37-59-390210,5537501,23,
5542582,5542605,2022-11-30_10-38-04-615769,5542608,23,
5547744,5547822,2022-11-30_10-38-09-948765,5547828,78,
5552841,5552861,2022-11-30_10-38-15-115464,5552864,20,
5557959,5558011,2022-11-30_10-38-20-390761,5558013,52,
5563066,5563107,2022-11-30_10-38-25-605294,5563110,41,
5568173,5568216,2022-11-30_10-38-30-836740,5568219,43,
5573292,5573341,2022-11-30_10-38-36-076719,5573345,49,
5578400,5578434,2022-11-30_10-38-41-285447,5578437,34,
5583509,5583557,2022-11-30_10-38-46-515094,5583563,48,
5588611,5588634,2022-11-30_10-38-51-728605,5588637,23,
5593722,5593749,2022-11-30_10-38-56-952992,5593752,27,
5598870,5603987,2022-11-30_10-39-02-274097,5604002,5117,
5604019,5604040,2022-11-30_10-39-07-499992,5604043,21,
5609134,5609166,2022-11-30_10-39-12-734695,5609171,32,
5614252,5614336,2022-11-30_10-39-18-042261,5614339,84,
5619365,5619385,2022-11-30_10-39-23-212057,5619388,20,
5624481,5624535,2022-11-30_10-39-28-486463,5624539,54,
5629580,5629606,2022-11-30_10-39-33-677314,5629610,26,
5634693,5634748,2022-11-30_10-39-38-945145,5634751,55,
5639806,5639896,2022-11-30_10-39-44-208419,5639899,90,
5644913,5644977,2022-11-30_10-39-49-407990,5644981,64,
5650013,5650032,2022-11-30_10-39-54-589942,5650035,19,
5655177,5655196,2022-11-30_10-39-59-881048,5655199,19,
5660284,5660303,2022-11-30_10-40-05-100967,5660305,19,
5665405,5665470,2022-11-30_10-40-10-387695,5665476,65,
5670547,5670575,2022-11-30_10-40-15-610288,5670578,28,
5675666,5675686,2022-11-30_10-40-20-842958,5675688,20,
5680775,5680794,2022-11-30_10-40-26-072651,5680797,19,
5685906,5685975,2022-11-30_10-40-31-370368,5685979,69,
5691030,5691093,2022-11-30_10-40-36-603453,5691098,63,
5696160,5696183,2022-11-30_10-40-41-818963,5696186,23,
5701279,5701300,2022-11-30_10-40-47-063236,5701303,21,
5706416,5706436,2022-11-30_10-40-52-312368,5706439,20,
5711538,5711612,2022-11-30_10-40-57-600777,5711617,74,
5716672,5716715,2022-11-30_10-41-02-821143,5716718,43,
5721800,5721820,2022-11-30_10-41-08-063385,5721823,20,
5726914,5726934,2022-11-30_10-41-13-297047,5726937,20,
5732048,5732068,2022-11-30_10-41-18-561080,5732071,20,
5737189,5737211,2022-11-30_10-41-23-819008,5737214,22,
5742316,5742387,2022-11-30_10-41-29-123914,5742397,71,
5747444,5747515,2022-11-30_10-41-34-363638,5747520,71,
5752561,5752612,2022-11-30_10-41-39-586810,5752617,51,
5757694,5757718,2022-11-30_10-41-44-814675,5757721,24,
5762841,5762932,2022-11-30_10-41-50-139323,5762938,91,
5767951,5767972,2022-11-30_10-41-55-310501,5767975,21,
5773078,5773121,2022-11-30_10-42-00-581772,5773124,43,
5778207,5778233,2022-11-30_10-42-05-809966,5778236,26,
5783313,5783334,2022-11-30_10-42-11-036269,5783337,21,
5788436,5788517,2022-11-30_10-42-16-341153,5788522,81,
5793554,5793574,2022-11-30_10-42-21-509752,5793576,20,
5798679,5798735,2022-11-30_10-42-26-797112,5798738,56,
5803814,5803848,2022-11-30_10-42-32-025132,5803853,34,
5808933,5808953,2022-11-30_10-42-37-256680,5808956,20,
5814054,5814075,2022-11-30_10-42-42-501972,5814078,21,
5819190,5819254,2022-11-30_10-42-47-793007,5819259,64,
5824325,5824345,2022-11-30_10-42-53-008209,5824348,20,
5829429,5829450,2022-11-30_10-42-58-236439,5829452,21,
5834548,5834568,2022-11-30_10-43-03-468975,5834571,20,
5839659,5839678,2022-11-30_10-43-08-696631,5839682,19,
5844787,5844874,2022-11-30_10-43-14-016653,5844881,87,
5849908,5849980,2022-11-30_10-43-19-240519,5849985,72,
5855014,5855066,2022-11-30_10-43-24-454413,5855069,52,
5860125,5860192,2022-11-30_10-43-29-682747,5860197,67,
5865232,5865289,2022-11-30_10-43-34-910721,5865295,57,
5870344,5870374,2022-11-30_10-43-40-123954,5870379,30,
5875451,5875489,2022-11-30_10-43-45-356478,5875494,38,
5880555,5880579,2022-11-30_10-43-50-571201,5880582,24,
5885697,5885718,2022-11-30_10-43-55-836023,5885721,21,
5890853,5890873,2022-11-30_10-44-01-113777,5890877,20,
5896005,5896099,2022-11-30_10-44-06-449114,5896104,94,
5901125,5901191,2022-11-30_10-44-11-673818,5901197,66,
5906225,5906245,2022-11-30_10-44-16-856873,5906249,20,
5911372,5911391,2022-11-30_10-44-22-125415,5911394,19,
5916479,5916499,2022-11-30_10-44-27-355232,5916502,20,
5921622,5921643,2022-11-30_10-44-32-625204,5921646,21,
5926741,5926803,2022-11-30_10-44-37-892067,5926809,62,
5931848,5931894,2022-11-30_10-44-43-112564,5931897,46,
5936956,5936983,2022-11-30_10-44-48-327548,5936985,27,
5942063,5942095,2022-11-30_10-44-53-558384,5942101,32,
5947206,5947225,2022-11-30_10-44-58-814505,5947229,19,
5952322,5952382,2022-11-30_10-45-04-096059,5952385,60,
5957428,5957492,2022-11-30_10-45-09-324473,5957495,64,
5962538,5962582,2022-11-30_10-45-14-535078,5962585,44,
5967647,5967704,2022-11-30_10-45-19-775206,5967709,57,
5972753,5972814,2022-11-30_10-45-25-001872,5972819,61,
5977862,5977905,2022-11-30_10-45-30-221297,5977909,43,
5982971,5983030,2022-11-30_10-45-35-445149,5983033,59,
5988077,5988117,2022-11-30_10-45-40-670840,5988122,40,
5993186,5993219,2022-11-30_10-45-45-892403,5993224,33,
5998337,5998356,2022-11-30_10-45-51-158757,5998359,19,
6003452,6003506,2022-11-30_10-45-56-429513,6003508,54,
6008564,6008615,2022-11-30_10-46-01-662326,6008619,51,
6013668,6013707,2022-11-30_10-46-06-852983,6013710,39,
6018784,6018809,2022-11-30_10-46-12-089149,6018811,25,
6023891,6023920,2022-11-30_10-46-17-320413,6023922,29,
6028991,6029010,2022-11-30_10-46-22-528153,6029013,19,
6034107,6034127,2022-11-30_10-46-27-767691,6034130,20,
6039214,6039245,2022-11-30_10-46-33-002204,6039248,31,
6044326,6044346,2022-11-30_10-46-38-229621,6044349,20,
6049467,6049486,2022-11-30_10-46-43-488070,6049489,19,
6054573,6054646,2022-11-30_10-46-48-768020,6054649,73,
6059691,6059738,2022-11-30_10-46-53-976439,6059741,47,
6064823,6064850,2022-11-30_10-46-59-217550,6064853,27,
6069929,6069977,2022-11-30_10-47-04-446636,6069982,48,
6075058,6075080,2022-11-30_10-47-09-685838,6075083,22,
6080180,6080250,2022-11-30_10-47-14-979470,6080253,70,
6085306,6085378,2022-11-30_10-47-20-216586,6085383,72,
6090414,6090459,2022-11-30_10-47-25-425830,6090462,45,
6095536,6095558,2022-11-30_10-47-30-652200,6095561,22,
6100731,6100763,2022-11-30_10-47-35-976205,6100766,32,
6105868,6105958,2022-11-30_10-47-41-300032,6105961,90,
6110992,6111012,2022-11-30_10-47-46-478121,6111015,20,
6116142,6116172,2022-11-30_10-47-51-757364,6116175,30,
6121277,6121334,2022-11-30_10-47-57-022767,6121336,57,
6126397,6126458,2022-11-30_10-48-02-293533,6126461,61,
6131518,6131577,2022-11-30_10-48-07-528960,6131582,59,
6136644,6136665,2022-11-30_10-48-12-737718,6136668,21,
6141776,6141806,2022-11-30_10-48-18-002147,6141810,30,
6146884,6146917,2022-11-30_10-48-23-224090,6146920,33,
6152010,6152090,2022-11-30_10-48-28-524887,6152093,80,
6157131,0,,6162266,-6157131,
6162279,6162299,2022-11-30_10-48-38-981839,6162302,20,
6167390,6167411,2022-11-30_10-48-44-207921,6167414,21,
6172503,6172584,2022-11-30_10-48-49-506363,6172587,81,
6177618,6177697,2022-11-30_10-48-54-741356,6177700,79,
6182742,6182816,2022-11-30_10-48-59-981918,6182819,74,
6187875,6187898,2022-11-30_10-49-05-179066,6187901,23,
6192998,6193098,2022-11-30_10-49-10-499891,6193101,100,
6198111,6198130,2022-11-30_10-49-15-657714,6198133,19,
6203243,6203307,2022-11-30_10-49-20-950045,6203310,64,
6208385,6208424,2022-11-30_10-49-26-184624,6208427,39,
6213515,6213610,2022-11-30_10-49-31-494072,6213613,95,
6218642,6218714,2022-11-30_10-49-36-718935,6218717,72,
6223764,6223831,2022-11-30_10-49-41-955481,6223834,67,
6228901,6228974,2022-11-30_10-49-47-194406,6228982,73,
6234039,6234120,2022-11-30_10-49-52-487906,6234123,81,
6239147,6239167,2022-11-30_10-49-57-651969,6239170,20,
6244258,6244282,2022-11-30_10-50-02-889254,6244285,24,
6249369,6249389,2022-11-30_10-50-08-114553,6249392,20,
6254493,6254552,2022-11-30_10-50-13-395443,6254557,59,
6259629,6259649,2022-11-30_10-50-18-614728,6259652,20,
6264769,6264789,2022-11-30_10-50-23-886020,6264793,20,
6269904,6270000,2022-11-30_10-50-29-188164,6270004,96,
6275010,6275032,2022-11-30_10-50-34-358904,6275035,22,
6280139,6280169,2022-11-30_10-50-39-617242,6280172,30,
6285274,6285297,2022-11-30_10-50-44-867709,6285300,23,
6290416,6290472,2022-11-30_10-50-50-159729,6290478,56,
6295525,6295583,2022-11-30_10-50-55-381987,6295588,58,
6300634,6300675,2022-11-30_10-51-00-607617,6300680,41,
6305743,6305778,2022-11-30_10-51-05-827188,6305781,35,
6310861,6310956,2022-11-30_10-51-11-141566,6310958,95,
6316000,6316086,2022-11-30_10-51-16-378072,6316091,86,
6321109,6321160,2022-11-30_10-51-21-589618,6321162,51,
6326216,6326271,2022-11-30_10-51-26-821336,6326276,55,
6331330,6331393,2022-11-30_10-51-32-049759,6331398,63,
6336437,6336467,2022-11-30_10-51-37-260124,6336470,30,
6341546,0,,6346648,-6341546,
6346669,6346762,2022-11-30_10-51-47-804168,6346765,93,
6351777,6351798,2022-11-30_10-51-52-961374,6351801,21,
6356937,6356977,2022-11-30_10-51-58-266020,6356980,40,
6362035,6362056,2022-11-30_10-52-03-462884,6362059,21,
6367178,6367230,2022-11-30_10-52-08-756643,6367233,52,
6372289,6372371,2022-11-30_10-52-14-028281,6372376,82,
6377426,6377488,2022-11-30_10-52-19-263357,6377493,62,
6382569,6382590,2022-11-30_10-52-24-497196,6382593,21,
6387672,6387764,2022-11-30_10-52-29-794152,6387768,92,
6392780,6392803,2022-11-30_10-52-34-953773,6392805,23,
6397902,6397975,2022-11-30_10-52-40-241718,6397978,73,
6403000,6403020,2022-11-30_10-52-45-412704,6403023,20,
6408156,6408194,2022-11-30_10-52-50-703402,6408197,38,
6413263,0,,6418363,-6413263,
6418375,6418396,2022-11-30_10-53-01-151314,6418399,21,
6423476,6423525,2022-11-30_10-53-06-394595,6423528,49,
6428577,6428601,2022-11-30_10-53-11-591419,6428605,24,
6433739,6433809,2022-11-30_10-53-16-921592,6433811,70,
6438838,6438902,2022-11-30_10-53-22-138129,6438904,64,
6443946,6443999,2022-11-30_10-53-27-359223,6444004,53,
6449063,6449102,2022-11-30_10-53-32-585006,6449105,39,
6454212,6454232,2022-11-30_10-53-37-837487,6454235,20,
6459352,6459372,2022-11-30_10-53-43-098073,6459374,20,
6464469,6464525,2022-11-30_10-53-48-355161,6464530,56,
6469581,6469622,2022-11-30_10-53-53-584304,6469627,41,
6474690,6479804,2022-11-30_10-53-58-819612,6479815,5114,
6479833,6479937,2022-11-30_10-54-04-129625,6479943,104,
6484917,6485027,2022-11-30_10-54-09-351640,6490047,110,
6490060,6490080,2022-11-30_10-54-14-526618,6490083,20,
6495180,6495247,2022-11-30_10-54-19-811787,6495250,67,
6500316,6500335,2022-11-30_10-54-25-019892,6500338,19,
6505468,6505489,2022-11-30_10-54-30-295751,6505492,21,
6510595,6510642,2022-11-30_10-54-35-573355,6510645,47,
6515726,6515746,2022-11-30_10-54-40-797846,6515750,20,
6520882,6520929,2022-11-30_10-54-46-102149,6520931,47,
6526019,6526111,2022-11-30_10-54-51-382119,6526115,92,
6531148,6531172,2022-11-30_10-54-56-584081,6531175,24,
6536282,6536356,2022-11-30_10-55-01-890339,6536359,74,
6541397,6541416,2022-11-30_10-55-07-072367,6541419,19,
6546523,6546575,2022-11-30_10-55-12-351541,6546578,52,
6551644,6551665,2022-11-30_10-55-17-557683,6551668,21,
6556746,6556866,2022-11-30_10-55-22-884025,6561885,120,
6561908,6561982,2022-11-30_10-55-28-110040,6561988,74,
6567039,6567068,2022-11-30_10-55-33-332193,6567071,29,
6572145,6572174,2022-11-30_10-55-38-552977,6572180,29,
6577261,6577283,2022-11-30_10-55-43-786360,6577286,22,
6582383,6582402,2022-11-30_10-55-49-023240,6582406,19,
6587491,6587518,2022-11-30_10-55-54-252612,6587520,27,
6592608,6592692,2022-11-30_10-55-59-550352,6592695,84,
6597718,6597738,2022-11-30_10-56-04-719559,6597741,20,
6602825,6602852,2022-11-30_10-56-09-947740,6602856,27,
6607937,6608000,2022-11-30_10-56-15-218026,6608005,63,
6613060,6613106,2022-11-30_10-56-20-442517,6613111,46,
6618201,6618228,2022-11-30_10-56-25-690180,6618231,27,
6623324,6623408,2022-11-30_10-56-30-990037,6623412,84,
6628431,6628491,2022-11-30_10-56-36-201374,6628495,60,
6633581,6633626,2022-11-30_10-56-41-448420,6633629,45,
6638709,6638731,2022-11-30_10-56-46-677889,6638734,22,
6643848,6643920,2022-11-30_10-56-51-985921,6643924,72,
6648966,6648987,2022-11-30_10-56-57-170997,6648990,21,
6654095,6654135,2022-11-30_10-57-02-429972,6654141,40,
6659228,6659250,2022-11-30_10-57-07-671010,6659253,22,
6664326,6664350,2022-11-30_10-57-12-898581,6664353,24,
6669454,6669472,2022-11-30_10-57-18-139030,6669475,18,
6674572,6674638,2022-11-30_10-57-23-423847,6674643,66,
6679689,6679725,2022-11-30_10-57-28-611216,6679728,36,
6684826,6684854,2022-11-30_10-57-33-875496,6684856,28,
6689953,6689976,2022-11-30_10-57-39-122164,6689978,23,
6695062,6695143,2022-11-30_10-57-44-398239,6695146,81,
6700178,6700258,2022-11-30_10-57-49-638726,6700263,80,
6705293,6705353,2022-11-30_10-57-54-866935,6705356,60,
6710415,6710457,2022-11-30_10-58-00-093401,6710461,42,
6715559,6715583,2022-11-30_10-58-05-325513,6715586,24,
6720700,6720721,2022-11-30_10-58-10-593133,6720724,21,
6725810,6725866,2022-11-30_10-58-15-856316,6725869,56,
6730923,6730966,2022-11-30_10-58-21-072907,6730969,43,
6736032,6736096,2022-11-30_10-58-26-306911,6736101,64,
6741140,6741197,2022-11-30_10-58-31-535666,6741200,57,
6746252,6746283,2022-11-30_10-58-36-751997,6746286,31,
6751389,6751410,2022-11-30_10-58-42-006068,6751413,21,
6756495,6756517,2022-11-30_10-58-47-227765,6756520,22,
6761639,6761705,2022-11-30_10-58-52-530926,6761708,66,
6766747,6766811,2022-11-30_10-58-57-754268,6766817,64,
6771883,6771911,2022-11-30_10-59-02-977713,6771916,28,
6776992,6777022,2022-11-30_10-59-08-210194,6777026,30,
6782103,6782194,2022-11-30_10-59-13-507230,6782197,91,
6787215,6787234,2022-11-30_10-59-18-673209,6787237,19,
6792322,6792401,2022-11-30_10-59-23-960787,6792405,79,
6797432,6797453,2022-11-30_10-59-29-135121,6797456,21,
6802621,6802705,2022-11-30_10-59-34-502257,6802708,84,
6807731,6807799,2022-11-30_10-59-39-722633,6807803,68,
6812831,6812850,2022-11-30_10-59-44-899276,6812853,19,
6817948,6818011,2022-11-30_10-59-50-172783,6818014,63,
6823056,6823130,2022-11-30_10-59-55-415028,6823135,74,
6828163,6828212,2022-11-30_11-00-00-629374,6828215,49,
6833268,6833288,2022-11-30_11-00-05-828195,6833292,20,
6838380,6838414,2022-11-30_11-00-11-070620,6838417,34,
6843488,6843522,2022-11-30_11-00-16-296022,6843526,34,
6848595,6848627,2022-11-30_11-00-21-518561,6848633,32,
6853703,6858815,2022-11-30_11-00-26-879584,6858819,5112,
6858819,6858895,2022-11-30_11-00-32-045303,6858898,76,
6863927,6863946,2022-11-30_11-00-37-207085,6863949,19,
6869034,6869053,2022-11-30_11-00-42-441720,6869056,19,
6874152,6874207,2022-11-30_11-00-47-720157,6874210,55,
6879260,6879319,2022-11-30_11-00-52-950406,6879322,59,
6884359,6884379,2022-11-30_11-00-58-134992,6884382,20,
6889515,6889535,2022-11-30_11-01-03-414554,6889538,20,
6894617,6894638,2022-11-30_11-01-08-639423,6894641,21,
6899766,6899849,2022-11-30_11-01-13-963560,6899855,83,
6904873,6904923,2022-11-30_11-01-19-172672,6904926,50,
6909975,6910093,2022-11-30_11-01-24-459716,6915099,118,
6915112,6920247,2022-11-30_11-01-29-742748,6920253,5135,
6920254,6920339,2022-11-30_11-01-34-949718,6920344,85,
6925379,6925434,2022-11-30_11-01-40-157903,6925437,55,
6930518,6930559,2022-11-30_11-01-45-402747,6930564,41,
6935646,6935666,2022-11-30_11-01-50-639466,6935669,20,
6940770,6940789,2022-11-30_11-01-55-886191,6940792,19,
6945887,6945954,2022-11-30_11-02-01-167301,6945959,67,
6951021,6951049,2022-11-30_11-02-06-389021,6951052,28,
6956147,6956166,2022-11-30_11-02-11-629733,6956170,19,
6961268,6961288,2022-11-30_11-02-16-874076,6961292,20,
6966392,6966479,2022-11-30_11-02-22-167768,6966484,87,
6971511,6971568,2022-11-30_11-02-27-385671,6971574,57,
6976619,6976657,2022-11-30_11-02-32-602216,6976660,38,
6981727,6981774,2022-11-30_11-02-37-825408,6981779,47,
6986857,6986876,2022-11-30_11-02-43-058564,6986879,19,
6991995,6992078,2022-11-30_11-02-48-382003,6992082,83,
6997125,6997144,2022-11-30_11-02-53-567448,6997147,19,
7002255,7002277,2022-11-30_11-02-58-823331,7002280,22,
7007379,7007401,2022-11-30_11-03-04-067312,7007403,22,
7012493,7012524,2022-11-30_11-03-09-311054,7012527,31,
7017603,7017687,2022-11-30_11-03-14-598021,7017689,84,
7022709,7022787,2022-11-30_11-03-19-814629,7022790,78,
7027849,7027894,2022-11-30_11-03-25-042290,7027899,45,
7032979,7032999,2022-11-30_11-03-30-268769,7033002,20,
7038109,7038199,2022-11-30_11-03-35-586217,7038203,90,
7043236,7043257,2022-11-30_11-03-40-767748,7043261,21,
7048353,7048405,2022-11-30_11-03-46-033038,7048407,52,
7053495,7053515,2022-11-30_11-03-51-261027,7053518,20,
7058618,7058638,2022-11-30_11-03-56-509331,7058641,20,
7063748,7063823,2022-11-30_11-04-01-814942,7063826,75,
7068854,7068876,2022-11-30_11-04-06-988278,7068879,22,
7073976,7074026,2022-11-30_11-04-12-256399,7074032,50,
7079104,7079128,2022-11-30_11-04-17-479974,7079131,24,
7084204,7084227,2022-11-30_11-04-22-701000,7084230,23,
7089335,7089356,2022-11-30_11-04-27-954347,7089359,21,
7094460,7094479,2022-11-30_11-04-33-194297,7094482,19,
7099584,7099644,2022-11-30_11-04-38-471561,7099650,60,
7104717,7104737,2022-11-30_11-04-43-702623,7104740,20,
7109830,7109851,2022-11-30_11-04-48-933638,7109854,21,
7114964,7115040,2022-11-30_11-04-54-244974,7115043,76,
7120068,7120143,2022-11-30_11-04-59-463500,7120146,75,
7125221,7125241,2022-11-30_11-05-04-690640,7125244,20,
7130327,7130367,2022-11-30_11-05-09-935302,7130369,40,
7135475,7135498,2022-11-30_11-05-15-200075,7135501,23,
7140590,7140649,2022-11-30_11-05-20-457039,7140652,59,
7145697,7145741,2022-11-30_11-05-25-683561,7145744,44,
7150809,7150839,2022-11-30_11-05-30-900173,7150842,30,
7155944,7155964,2022-11-30_11-05-36-148073,7155967,20,
7161090,7161110,2022-11-30_11-05-41-408638,7161113,20,
7166198,7166218,2022-11-30_11-05-46-637336,7166221,20,
7171342,7171361,2022-11-30_11-05-51-906466,7171364,19,
7176442,7176466,2022-11-30_11-05-57-127434,7176468,24,
7181545,7181659,2022-11-30_11-06-02-447074,7186662,114,
7186675,7186712,2022-11-30_11-06-07-612245,7186715,37,
7191774,7191793,2022-11-30_11-06-12-817157,7191797,19,
7196882,7196965,2022-11-30_11-06-18-116143,7196968,83,
7202001,7202021,2022-11-30_11-06-23-298919,7202024,20,
7207119,7207177,2022-11-30_11-06-28-566840,7207179,58,
7212228,7212257,2022-11-30_11-06-33-774988,7212260,29,
7217326,7217346,2022-11-30_11-06-38-989085,7217349,20,
7222442,7222474,2022-11-30_11-06-44-233795,7222478,32,
7227574,7227595,2022-11-30_11-06-49-475501,7227598,21,
7232729,7232782,2022-11-30_11-06-54-783339,7232785,53,
7237837,7237896,2022-11-30_11-07-00-020406,7237899,59,
7242945,7242995,2022-11-30_11-07-05-230582,7242997,50,
7248053,7248088,2022-11-30_11-07-10-452561,7248093,35,
7253152,7253197,2022-11-30_11-07-15-675987,7253200,45,
7258269,7258304,2022-11-30_11-07-20-897830,7258307,35,
7263391,7263413,2022-11-30_11-07-26-142571,7263416,22,
7268571,7268600,2022-11-30_11-07-31-448030,7268603,29,
7273670,7273696,2022-11-30_11-07-36-665938,7273699,26,
7278823,7278904,2022-11-30_11-07-41-996869,7278907,81,
7283928,7283998,2022-11-30_11-07-47-219087,7284003,70,
7289028,7289047,2022-11-30_11-07-52-384231,7289050,19,
7294136,7294157,2022-11-30_11-07-57-618364,7294160,21,
7299245,7299265,2022-11-30_11-08-02-841052,7299268,20,
7304362,7304406,2022-11-30_11-08-08-110829,7304415,44,
7309473,7309510,2022-11-30_11-08-13-333052,7309514,37,
7314573,7314598,2022-11-30_11-08-18-536923,7314600,25,
7319708,7319730,2022-11-30_11-08-23-792814,7319733,22,
7324815,7324835,2022-11-30_11-08-29-013017,7324839,20,
7329948,7330020,2022-11-30_11-08-34-328487,7330023,72,
7335070,7335129,2022-11-30_11-08-39-554110,7335132,59,
7340209,7340230,2022-11-30_11-08-44-777973,7340233,21,
7345339,7345359,2022-11-30_11-08-50-032461,7345363,20,
7350466,7350540,2022-11-30_11-08-55-324108,7350546,74,
7355604,7355648,2022-11-30_11-09-00-548247,7355654,44,
7360738,7360828,2022-11-30_11-09-05-863802,7360831,90,
7365861,7365925,2022-11-30_11-09-11-086599,7365928,64,
7370988,7371058,2022-11-30_11-09-16-334175,7371060,70,
7376119,7376144,2022-11-30_11-09-21-536911,7376146,25,
7381231,7386361,2022-11-30_11-09-26-862240,7386377,5130,
7386399,7386450,2022-11-30_11-09-32-083656,7386452,51,
7391467,7391487,2022-11-30_11-09-37-242617,7391489,20,
7396586,7396608,2022-11-30_11-09-42-485560,7396611,22,
7401704,7401761,2022-11-30_11-09-47-758512,7401764,57,
7406839,7406858,2022-11-30_11-09-52-986818,7406862,19,
7411990,7412012,2022-11-30_11-09-58-261402,7412015,22,
7417113,7417153,2022-11-30_11-10-03-522634,7417155,40,
7422233,7422254,2022-11-30_11-10-08-740502,7422257,21,
7427362,7427382,2022-11-30_11-10-13-991680,7427385,20,
7432628,7432669,2022-11-30_11-10-19-404798,7432672,41,
7437730,7442841,2022-11-30_11-10-24-785538,7442854,5111,
7442867,7447949,2022-11-30_11-10-30-093140,7447954,5082,
7447955,7447982,2022-11-30_11-10-35-066694,7447985,27,
7453065,7453093,2022-11-30_11-10-40-298072,7453098,28,
7458179,7458246,2022-11-30_11-10-45-573638,7458249,67,
7463289,7463309,2022-11-30_11-10-50-772184,7463311,20,
7468521,7468582,2022-11-30_11-10-56-170002,7468584,61,
7473653,7473677,2022-11-30_11-11-01-387827,7473679,24,
7478762,7483881,2022-11-30_11-11-06-721056,7483891,5119,
7483903,7483929,2022-11-30_11-11-11-879413,7483932,26,
7489026,7494151,2022-11-30_11-11-17-261819,7494156,5125,
7494157,7494196,2022-11-30_11-11-22-388709,7494199,39,
7499282,7499303,2022-11-30_11-11-27-617945,7499306,21,
7504390,7504410,2022-11-30_11-11-32-840216,7504414,20,
7509527,7509547,2022-11-30_11-11-38-098511,7509551,20,
7514634,7514654,2022-11-30_11-11-43-329072,7514657,20,
7519754,7519829,2022-11-30_11-11-48-609360,7519834,75,
7524882,7524906,2022-11-30_11-11-53-822186,7524908,24,
7530018,7530038,2022-11-30_11-11-59-079668,7530041,20,
7535135,7535207,2022-11-30_11-12-04-368066,7535210,72,
7540243,7540321,2022-11-30_11-12-09-600606,7540327,78,
7545356,7545419,2022-11-30_11-12-14-824298,7545422,63,
7550465,7550526,2022-11-30_11-12-20-048364,7550531,61,
7555571,7555633,2022-11-30_11-12-25-269701,7555636,62,
7560680,7560719,2022-11-30_11-12-30-484543,7560722,39,
7565788,7565836,2022-11-30_11-12-35-714916,7565842,48,
7570890,7570911,2022-11-30_11-12-40-909940,7570914,21,
7576006,7576042,2022-11-30_11-12-46-157990,7576045,36,
7581114,7581148,2022-11-30_11-12-51-387720,7581153,34,
7586223,7586266,2022-11-30_11-12-56-606809,7586269,43,
7591326,7591348,2022-11-30_11-13-01-834025,7591350,22,
7596481,7596557,2022-11-30_11-13-07-160389,7596562,76,
7601580,7601600,2022-11-30_11-13-12-333200,7601603,20,
7606735,7606769,2022-11-30_11-13-17-613189,7606774,34,
7611841,7611861,2022-11-30_11-13-22-840269,7611865,20,
7616948,7616969,2022-11-30_11-13-28-073274,7616972,21,
7622105,7622142,2022-11-30_11-13-33-367888,7622145,37,
7627214,7627243,2022-11-30_11-13-38-591744,7627246,29,
7632321,7632355,2022-11-30_11-13-43-819253,7632358,34,
7637428,7637453,2022-11-30_11-13-49-037204,7637456,25,
7642563,7642584,2022-11-30_11-13-54-292111,7642587,21,
7647685,7647756,2022-11-30_11-13-59-583717,7647758,71,
7652791,7652810,2022-11-30_11-14-04-761497,7652814,19,
7657946,7657969,2022-11-30_11-14-10-038408,7657971,23,
7663052,7663076,2022-11-30_11-14-15-265353,7663081,24,
7668204,7668279,2022-11-30_11-14-20-590212,7668284,75,
7673311,7673374,2022-11-30_11-14-25-811020,7673379,63,
7678420,7678481,2022-11-30_11-14-31-032806,7678484,61,
7683523,7683543,2022-11-30_11-14-36-224259,7683546,20,
7688639,7688677,2022-11-30_11-14-41-478583,7688680,38,
7693747,7693787,2022-11-30_11-14-46-701868,7693791,40,
7698855,7698881,2022-11-30_11-14-51-918737,7698884,26,