RD,TS_received,TS_sent,AK,RoundTrip,
78643,83724,2022-11-02_20-28-49-703926,83733,5081,
83746,83773,2022-11-02_20-28-54-836764,83775,27,
88833,93951,2022-11-02_20-29-00-149123,93960,5118,
93973,99091,2022-11-02_20-29-05-371390,99107,5118,
99127,104198,2022-11-02_20-29-10-696559,104213,5071,
104232,109306,2022-11-02_20-29-16-020654,109321,5074,
109340,114414,2022-11-02_20-29-21-245147,114427,5074,
114446,119522,2022-11-02_20-29-26-465852,119533,5076,
119555,119660,2022-11-02_20-29-31-597251,124630,105,
124649,129773,2022-11-02_20-29-36-912957,129789,5124,
129810,134881,2022-11-02_20-29-42-124288,134897,5071,
134918,139985,2022-11-02_20-29-47-457946,139994,5067,
140005,140025,2022-11-02_20-29-52-454162,140028,20,
145105,145158,2022-11-02_20-29-57-700559,145161,53,
150204,150226,2022-11-02_20-30-02-886853,150228,22,
155321,160459,2022-11-02_20-30-08-238034,160469,5138,
160481,160566,2022-11-02_20-30-13-468542,160568,85,
165600,170738,2022-11-02_20-30-18-691042,170749,5138,
170761,170877,2022-11-02_20-30-24-028130,175880,116,
175892,181004,2022-11-02_20-30-29-308136,181020,5112,
181041,181082,2022-11-02_20-30-34-461045,181085,41,
186117,191236,2022-11-02_20-30-39-786194,191252,5119,
191264,191291,2022-11-02_20-30-44-913597,191294,27,
196340,201453,2022-11-02_20-30-50-230879,201461,5113,
201473,201493,2022-11-02_20-30-55-358997,201496,20,
206572,211668,2022-11-02_20-31-00-777864,211677,5096,
211689,216808,2022-11-02_20-31-05-898709,216824,5119,
216846,221909,2022-11-02_20-31-11-223928,221922,5063,
221943,221999,2022-11-02_20-31-16-344117,222002,56,
227030,227090,2022-11-02_20-31-21-566353,227093,60,
232170,232196,2022-11-02_20-31-26-792762,232199,26,
237302,242416,2022-11-02_20-31-32-113138,242433,5114,
242454,242558,2022-11-02_20-31-37-389556,242560,104,
247568,247602,2022-11-02_20-31-42-558197,247607,34,
252701,252722,2022-11-02_20-31-47-799840,252725,21,
257808,262913,2022-11-02_20-31-53-105375,262922,5105,
262937,268072,2022-11-02_20-31-58-429826,268082,5135,
268095,268116,2022-11-02_20-32-03-564904,268119,21,
273185,278321,2022-11-02_20-32-08-880133,278336,5136,
278358,283429,2022-11-02_20-32-14-201061,283444,5071,
283465,288536,2022-11-02_20-32-19-422791,288553,5071,
288574,288604,2022-11-02_20-32-24-542272,288607,30,
293646,298790,2022-11-02_20-32-29-867259,298800,5144,
298814,298909,2022-11-02_20-32-35-090330,298913,95,
303896,0,,304000,-303896,
309009,309031,2022-11-02_20-32-45-448553,309034,22,
314137,314221,2022-11-02_20-32-50-757811,314224,84,
319279,319323,2022-11-02_20-32-55-984472,319326,44,
324395,329527,2022-11-02_20-33-01-305075,329536,5132,
329548,329632,2022-11-02_20-33-06-526665,329635,84,
334638,339753,2022-11-02_20-33-11-853981,339768,5115,
339789,344853,2022-11-02_20-33-17-075509,344866,5064,
344886,349969,2022-11-02_20-33-22-298659,349984,5083,
350002,355112,2022-11-02_20-33-27-623169,355121,5110,
355143,355223,2022-11-02_20-33-32-743351,355226,80,
360263,365396,2022-11-02_20-33-38-070445,365405,5133,
365418,370538,2022-11-02_20-33-43-291198,370548,5120,
370570,375694,2022-11-02_20-33-48-614045,375709,5124,
375723,375768,2022-11-02_20-33-53-769390,375772,45,
380807,385909,2022-11-02_20-33-59-061145,385918,5102,
385930,391037,2022-11-02_20-34-04-281555,391047,5107,
391059,391088,2022-11-02_20-34-09-448823,391091,29,
396180,396242,2022-11-02_20-34-14-728473,396245,62,
401327,406455,2022-11-02_20-34-20-051933,406464,5128,
406483,406547,2022-11-02_20-34-25-275015,406551,64,
411613,411647,2022-11-02_20-34-30-498270,411652,34,
416752,416772,2022-11-02_20-34-35-745075,416775,20,
421867,421943,2022-11-02_20-34-41-043883,421945,76,
427022,427053,2022-11-02_20-34-46-269618,427056,31,
432123,432155,2022-11-02_20-34-51-489288,432158,32,
437237,437257,2022-11-02_20-34-56-715989,437261,20,
442379,447488,2022-11-02_20-35-02-037873,447497,5109,
447508,452632,2022-11-02_20-35-07-260512,452644,5124,
452655,457740,2022-11-02_20-35-12-586209,457753,5085,
457774,462846,2022-11-02_20-35-17-910168,462857,5072,
462878,462970,2022-11-02_20-35-23-030546,462975,92,
467957,473068,2022-11-02_20-35-28-312146,473077,5111,
473093,478212,2022-11-02_20-35-33-577576,478228,5119,
478247,483320,2022-11-02_20-35-38-800951,483335,5073,
483356,483467,2022-11-02_20-35-44-022966,488420,111,
488433,488474,2022-11-02_20-35-49-148010,488477,41,
493537,493571,2022-11-02_20-35-54-365745,493574,34,
498652,503754,2022-11-02_20-35-59-792177,503766,5102,
503787,508900,2022-11-02_20-36-05-014896,508915,5113,
508938,514006,2022-11-02_20-36-10-229789,514015,5068,
514028,514091,2022-11-02_20-36-15-357814,514094,63,
519116,524230,2022-11-02_20-36-20-580205,524245,5114,
524265,524296,2022-11-02_20-36-25-804482,524299,31,
529334,534459,2022-11-02_20-36-31-025421,534471,5125,
534482,539566,2022-11-02_20-36-36-349822,539576,5084,
539596,544674,2022-11-02_20-36-41-674783,544689,5078,
544709,549778,2022-11-02_20-36-46-896598,549791,5069,
549814,554885,2022-11-02_20-36-52-119123,554894,5071,
554906,554985,2022-11-02_20-36-57-235008,554988,79,
559997,560017,2022-11-02_20-37-02-389014,560020,20,
565109,570215,2022-11-02_20-37-07-684369,570225,5106,
570243,575323,2022-11-02_20-37-13-008910,575332,5080,
575344,575392,2022-11-02_20-37-18-125222,575396,48,
580448,585568,2022-11-02_20-37-23-454247,585580,5120,
585592,590696,2022-11-02_20-37-28-676948,590705,5104,
590718,595829,2022-11-02_20-37-33-899369,595844,5111,
595865,600945,2022-11-02_20-37-39-226176,600955,5080,
600967,600986,2022-11-02_20-37-44-322221,600990,19,
606066,611187,2022-11-02_20-37-49-628031,611196,5121,
611208,616321,2022-11-02_20-37-54-891442,616336,5113,
616357,621421,2022-11-02_20-38-00-138889,621431,5064,
621443,621509,2022-11-02_20-38-05-336669,621512,66,
626533,626616,2022-11-02_20-38-10-558757,626619,83,
631650,636754,2022-11-02_20-38-15-883893,636769,5104,
636791,641860,2022-11-02_20-38-21-105399,641876,5069,
641897,641923,2022-11-02_20-38-26-226841,641926,26,
646965,647013,2022-11-02_20-38-31-447571,647015,48,
652091,657193,2022-11-02_20-38-36-883553,657203,5102,
657222,662327,2022-11-02_20-38-42-046852,662335,5105,
662355,662421,2022-11-02_20-38-47-219216,662423,66,
667442,672560,2022-11-02_20-38-52-542861,672575,5118,
672596,
677651,677718,2022-11-02_20-39-02-884895,677721,67,
682773,682823,2022-11-02_20-39-08-109420,687917,50,
687935,687955,2022-11-02_20-39-13-360844,687958,20,
693049,693136,2022-11-02_20-39-18-665885,693139,87,
698156,703297,2022-11-02_20-39-23-979634,703311,5141,
703329,708403,2022-11-02_20-39-29-309694,708414,5074,
708433,713542,2022-11-02_20-39-34-526960,713551,5109,
713568,718694,2022-11-02_20-39-39-749538,718703,5126,
718715,723809,2022-11-02_20-39-44-972874,723822,5094,
723840,728961,2022-11-02_20-39-50-299259,728978,5121,
728999,734063,2022-11-02_20-39-55-523460,734076,5064,
734098,734150,2022-11-02_20-40-00-643833,734152,52,
739183,739250,2022-11-02_20-40-05-863292,739256,67,
744290,749395,2022-11-02_20-40-11-187785,749410,5105,
749430,754495,2022-11-02_20-40-16-718798,754509,5065,
754529,759609,2022-11-02_20-40-21-734644,759624,5080,
759640,764719,2022-11-02_20-40-26-956677,764734,5079,
764748,764866,2022-11-02_20-40-32-056841,769826,118,
769845,774956,2022-11-02_20-40-37-401755,774966,5111,
774979,780083,2022-11-02_20-40-42-624185,780092,5104,
780105,780169,2022-11-02_20-40-47-744300,780173,64,
785229,790351,2022-11-02_20-40-53-033024,790359,5122,
790372,790393,2022-11-02_20-40-58-213805,790396,21,
795490,795573,2022-11-02_20-41-03-514618,795577,83,
800613,805743,2022-11-02_20-41-08-839776,805752,5130,
805764,805872,2022-11-02_20-41-14-029674,810844,108,
810862,815965,2022-11-02_20-41-19-284998,815973,5103,
815991,816072,2022-11-02_20-41-24-508186,816077,81,
821111,826239,2022-11-02_20-41-29-833729,826252,5128,
826264,831347,2022-11-02_20-41-35-046145,831358,5083,
831379,836448,2022-11-02_20-41-40-380005,836457,5069,
836475,841586,2022-11-02_20-41-45-601691,841601,5111,
841623,841678,2022-11-02_20-41-50-721721,841681,55,
846703,851815,2022-11-02_20-41-55-944319,851830,5112,
851852,0,,856945,-851852,
856964,856983,2022-11-02_20-42-06-395431,856987,19,
862062,867160,2022-11-02_20-42-11-714316,867169,5098,
867180,867201,2022-11-02_20-42-16-865974,867204,21,
872275,877394,2022-11-02_20-42-22-263452,877409,5119,
877429,882494,2022-11-02_20-42-27-429770,882508,5065,
882530,882574,2022-11-02_20-42-32-604779,882579,44,
887606,892731,2022-11-02_20-42-37-826666,892746,5125,
892761,892813,2022-11-02_20-42-43-082664,892816,52,
897845,897878,2022-11-02_20-42-48-272255,897882,33,
902944,902986,2022-11-02_20-42-53-494350,902988,42,
908118,913238,2022-11-02_20-42-58-921622,913254,5120,
913273,918346,2022-11-02_20-43-04-145305,918361,5073,
918374,923467,2022-11-02_20-43-09-468181,923476,5093,
923489,923509,2022-11-02_20-43-14-507561,923512,20,
928576,928695,2022-11-02_20-43-19-807098,933716,119,
933737,938824,2022-11-02_20-43-25-136591,938839,5087,
938861,943926,2022-11-02_20-43-30-344102,943934,5065,
943946,944000,2022-11-02_20-43-35-479550,944004,54,
949045,954174,2022-11-02_20-43-40-803995,954183,5129,
954194,959281,2022-11-02_20-43-46-026168,959299,5087,
959311,964388,2022-11-02_20-43-51-248001,964404,5077,
964425,969492,2022-11-02_20-43-56-572026,969501,5067,
969514,969533,2022-11-02_20-44-01-612003,969537,19,
974654,979791,2022-11-02_20-44-07-019024,979800,5137,
979812,979832,2022-11-02_20-44-12-151897,979835,20,
984941,990097,2022-11-02_20-44-17-463895,990106,5156,
990118,995229,2022-11-02_20-44-22-788312,995243,5111,
995255,1000359,2022-11-02_20-44-28-010089,1000368,5104,
1000387,1000414,2022-11-02_20-44-33-235832,1000416,27,
1005479,1010605,2022-11-02_20-44-38-559059,1010613,5126,
1010625,1010650,2022-11-02_20-44-43-705687,1010653,25,
1015720,1015822,2022-11-02_20-44-49-003975,1015825,102,
1020831,1020930,2022-11-02_20-44-54-199717,1020935,99,
1025939,1025959,2022-11-02_20-44-59-367689,1025963,20,
1031065,1031086,2022-11-02_20-45-04-614440,1031089,21,
1036172,1036240,2022-11-02_20-45-09-893278,1036243,68,
1041289,1041397,2022-11-02_20-45-15-150004,1046421,108,
1046433,1051561,2022-11-02_20-45-20-440964,1051570,5128,
1051582,1051602,2022-11-02_20-45-25-622547,1051605,20,
1056680,1061820,2022-11-02_20-45-30-976523,1061829,5140,
1061841,1061862,2022-11-02_20-45-36-129272,1061865,21,
1066951,1067051,2022-11-02_20-45-41-424462,1067053,100,
1072068,1072147,2022-11-02_20-45-46-655655,1072150,79,
1077190,1082317,2022-11-02_20-45-51-981339,1082333,5127,
1082346,1082366,2022-11-02_20-45-57-111614,1082369,20,
1087456,1087475,2022-11-02_20-46-02-345714,1087478,19,
1092575,1092655,2022-11-02_20-46-07-650342,1092659,80,
1097696,1097778,2022-11-02_20-46-12-890440,1097781,82,
1102810,1102857,2022-11-02_20-46-18-092459,1102860,47,
1107938,1107958,2022-11-02_20-46-23-316453,1107961,20,
1113067,1113087,2022-11-02_20-46-28-565870,1113090,20,
1118191,1123318,2022-11-02_20-46-33-965187,1123330,5127,
1123342,1123362,2022-11-02_20-46-39-097098,1123365,20,
1128457,1133573,2022-11-02_20-46-44-409637,1133590,5116,
1133610,1138678,2022-11-02_20-46-49-734638,1138693,5068,
1138715,1143785,2022-11-02_20-46-54-933290,1143800,5070,
1143823,1143855,2022-11-02_20-47-00-077168,1143860,32,
1148902,1154028,2022-11-02_20-47-05-401543,1154038,5126,
1154057,1154077,2022-11-02_20-47-10-541586,1154079,20,
1159139,1164241,2022-11-02_20-47-16-055150,1164251,5102,
1164263,1169344,2022-11-02_20-47-21-069628,1169353,5081,
1169364,1169384,2022-11-02_20-47-26-219836,1169387,20,
1174495,1174562,2022-11-02_20-47-31-514759,1174565,67,
1179612,1179685,2022-11-02_20-47-36-769303,1179687,73,
1184753,1184856,2022-11-02_20-47-42-061313,1189876,103,
1189898,1195020,2022-11-02_20-47-47-337363,1195036,5122,
1195049,1200149,2022-11-02_20-47-52-609431,1200159,5100,
1200171,1205310,2022-11-02_20-47-57-832234,1205325,5139,
1205344,1205371,2022-11-02_20-48-03-055541,1205374,27,
1210422,1215561,2022-11-02_20-48-08-329553,1215570,5139,
1215582,1220699,2022-11-02_20-48-13-601560,1220708,5117,
1220721,1220774,2022-11-02_20-48-18-823404,1220776,53,
1225824,1230964,2022-11-02_20-48-24-046611,1230973,5140,
1230985,1231006,2022-11-02_20-48-29-294648,1231014,21,
1236075,1236095,2022-11-02_20-48-34-500961,1236098,20,
1241210,1241286,2022-11-02_20-48-39-819165,1241289,76,
1246324,1251449,2022-11-02_20-48-45-141383,1251462,5125,
1251482,1251502,2022-11-02_20-48-50-280428,1251506,20,
1256561,1261685,2022-11-02_20-48-55-586509,1261693,5124,
1261705,1261785,2022-11-02_20-49-00-805496,1261788,80,
1266826,1271921,2022-11-02_20-49-06-133518,1271931,5095,
1271949,1277044,2022-11-02_20-49-11-356267,1277060,5095,
1277074,1277098,2022-11-02_20-49-16-483853,1277101,24,
1282176,1287285,2022-11-02_20-49-21-801051,1287293,5109,
1287305,1287391,2022-11-02_20-49-27-023514,1287394,86,
1292406,1292433,2022-11-02_20-49-32-179191,1292437,27,
1297515,1297538,2022-11-02_20-49-37-405022,1297541,23,
1302645,1302665,2022-11-02_20-49-42-656438,1302668,20,
1307779,1307800,2022-11-02_20-49-47-916889,1307802,21,
1312893,1318024,2022-11-02_20-49-53-340544,1318039,5131,
1318061,1323132,2022-11-02_20-49-58-493909,1323148,5071,
1323169,1328239,2022-11-02_20-50-03-837415,1328254,5070,
1328274,1333341,2022-11-02_20-50-09-007587,1333351,5067,
1333370,1338455,2022-11-02_20-50-14-233004,1338472,5085,
1338493,1343559,2022-11-02_20-50-19-507094,1343568,5066,
1343581,1343611,2022-11-02_20-50-24-573439,1343615,30,
1348680,1353812,2022-11-02_20-50-29-900289,1353821,5132,
1353833,1353922,2022-11-02_20-50-35-095548,1353925,89,
1358954,1364073,2022-11-02_20-50-40-445848,1364089,5119,
1364108,1369175,2022-11-02_20-50-45-668125,1369183,5067,
1369195,1369234,2022-11-02_20-50-50-788387,1369237,39,
1374295,1379396,2022-11-02_20-50-56-114675,1379410,5101,
1379429,1384562,2022-11-02_20-51-01-437742,1384578,5133,
1384600,1389670,2022-11-02_20-51-06-660810,1389686,5070,
1389706,1394771,2022-11-02_20-51-11-882201,1394780,5065,
1394793,1394836,2022-11-02_20-51-17-006491,1394839,43,
1399882,1405017,2022-11-02_20-51-22-226041,1405026,5135,
1405038,1410139,2022-11-02_20-51-27-652094,1410148,5101,
1410163,1410240,2022-11-02_20-51-32-774672,1410243,77,
1415296,1415344,2022-11-02_20-51-37-997516,1415347,48,
1420404,1425536,2022-11-02_20-51-43-320157,1425544,5132,
1425556,1430660,2022-11-02_20-51-48-543045,1430669,5104,
1430688,1435771,2022-11-02_20-51-53-867620,1435788,5083,
1435808,1435845,2022-11-02_20-51-58-989792,1435848,37,
1440887,1446019,2022-11-02_20-52-04-313082,1446029,5132,
1446041,1451143,2022-11-02_20-52-09-535971,1451152,5102,
1451165,1456281,2022-11-02_20-52-14-757498,1456298,5116,
1456320,1456366,2022-11-02_20-52-20-005624,1456369,46,
1461396,1466514,2022-11-02_20-52-25-266180,1466525,5118,
1466538,1471641,2022-11-02_20-52-30-437627,1471650,5103,
1471669,1476796,2022-11-02_20-52-35-851784,1476811,5127,
1476832,1481909,2022-11-02_20-52-41-075408,1481925,5077,
1481940,1487059,2022-11-02_20-52-46-399810,1487069,5119,
1487089,1492167,2022-11-02_20-52-51-621689,1492176,5078,
1492196,1497310,2022-11-02_20-52-56-808574,1497319,5114,
1497337,1497364,2022-11-02_20-53-01-966080,1497367,27,
1502456,1507595,2022-11-02_20-53-07-289493,1507604,5139,
1507616,1507662,2022-11-02_20-53-12-514158,1507664,46,
1512747,1517868,2022-11-02_20-53-17-837425,1517878,5121,
1517892,1523014,2022-11-02_20-53-23-163314,1523030,5122,
1523052,1523071,2022-11-02_20-53-28-284075,1523074,19,
1528126,1533256,2022-11-02_20-53-33-556921,1533265,5130,
1533277,1533297,2022-11-02_20-53-38-747502,1533300,20,
1538408,1538482,2022-11-02_20-53-44-053399,1538488,74,
1543529,1543590,2022-11-02_20-53-49-275780,1543593,61,
1548670,1553774,2022-11-02_20-53-55-110299,1553783,5104,
1553795,1558912,2022-11-02_20-53-59-821501,1558921,5117,
1558933,1564053,2022-11-02_20-54-05-044076,1564070,5120,
1564090,1569160,2022-11-02_20-54-10-368783,1569170,5070,
1569190,1574271,2022-11-02_20-54-15-693325,1574281,5081,
1574293,1579396,2022-11-02_20-54-20-813768,1579405,5103,
1579422,1579498,2022-11-02_20-54-26-037023,1579500,76,
1584547,1589650,2022-11-02_20-54-31-362178,1589666,5103,
1589683,1589804,2022-11-02_20-54-36-584681,1594819,121,
1594840,1599920,2022-11-02_20-54-41-876080,1599931,5080,
1599952,1605051,2022-11-02_20-54-47-131493,1605067,5099,
1605090,1610157,2022-11-02_20-54-52-298698,1610172,5067,
1610194,1615266,2022-11-02_20-54-57-575509,1615281,5072,
1615303,1620374,2022-11-02_20-55-02-797912,1620390,5071,
1620413,1620522,2022-11-02_20-55-08-021125,1625482,109,
1625504,1625531,2022-11-02_20-55-13-143978,1625533,27,
1630586,1630623,2022-11-02_20-55-18-365773,1630626,37,
1635734,1635826,2022-11-02_20-55-23-687972,1635830,92,
1640866,1645994,2022-11-02_20-55-28-911066,1646009,5128,
1646028,1646049,2022-11-02_20-55-34-150694,1646052,21,
1651107,1656281,2022-11-02_20-55-39-457408,1656296,5174,
1656317,1656342,2022-11-02_20-55-44-681626,1656345,25,
1661393,1666521,2022-11-02_20-55-50-006392,1666529,5128,
1666542,1666562,2022-11-02_20-55-55-147814,1666565,20,
1671655,1671710,2022-11-02_20-56-00-405877,1671713,55,
1676776,1681903,2022-11-02_20-56-05-878758,1681918,5127,
1681936,1681956,2022-11-02_20-56-10-900233,1681960,20,
1687015,1692139,2022-11-02_20-56-16-221647,1692148,5124,
1692160,1692182,2022-11-02_20-56-21-377000,1692186,22,
1697254,1702364,2022-11-02_20-56-26-665473,1702372,5110,
1702384,1702404,2022-11-02_20-56-31-841056,1702407,20,
1707525,1707552,2022-11-02_20-56-37-111689,1707554,27,
1712629,1712747,2022-11-02_20-56-42-370928,1717753,118,
1717766,1717786,2022-11-02_20-56-47-582285,1717788,20,
1722870,1727976,2022-11-02_20-56-52-981999,1727992,5106,
1728012,1733078,2022-11-02_20-56-58-204991,1733093,5066,
1733111,1738192,2022-11-02_20-57-03-529372,1738208,5081,
1738229,1743300,2022-11-02_20-57-08-649475,1743315,5071,
1743336,1748408,2022-11-02_20-57-13-871927,1748423,5072,
1748439,1753516,2022-11-02_20-57-19-196888,1753529,5077,
1753548,1758624,2022-11-02_20-57-24-420329,1758635,5076,
1758654,1763732,2022-11-02_20-57-29-641926,1763743,5078,
1763756,1768946,2022-11-02_20-57-34-865046,1768955,5190,
1768967,1769055,2022-11-02_20-57-40-087627,1769058,88,
1774067,1774111,2022-11-02_20-57-45-262160,1774114,44,
1779182,1784314,2022-11-02_20-57-50-610496,1784331,5132,
1784346,1784365,2022-11-02_20-57-55-760345,1784369,19,
1789426,1794556,2022-11-02_20-58-01-082953,1794564,5130,
1794576,1794608,2022-11-02_20-58-06-234639,1794610,32,
1799666,1804804,2022-11-02_20-58-11-524764,1804820,5138,
1804841,1804876,2022-11-02_20-58-16-749473,1804879,35,
1809915,1815037,2022-11-02_20-58-21-970029,1815050,5122,
1815062,1815171,2022-11-02_20-58-27-245843,1820181,109,
1820193,1820277,2022-11-02_20-58-32-519486,1820280,84,
1825301,1830411,2022-11-02_20-58-37-845365,1830426,5110,
1830448,1835549,2022-11-02_20-58-43-065075,1835566,5101,
1835579,1835601,2022-11-02_20-58-48-206444,1835603,22,
1840663,1845808,2022-11-02_20-58-53-509433,1845817,5145,
1845829,1850957,2022-11-02_20-58-58-732320,1850969,5128,
1850981,1851024,2022-11-02_20-59-03-992913,1851028,43,
1856070,1861200,2022-11-02_20-59-09-279397,1861209,5130,
1861228,1861300,2022-11-02_20-59-14-503695,1861304,72,
1866310,1871423,2022-11-02_20-59-19-724152,1871438,5113,
1871459,1876528,2022-11-02_20-59-25-048640,1876545,5069,
1876566,1876607,2022-11-02_20-59-30-168505,1876611,41,
1881644,1886774,2022-11-02_20-59-35-485794,1886788,5130,
1886800,1886820,2022-11-02_20-59-40-627167,1886823,20,
1891886,1897000,2022-11-02_20-59-45-938967,1897009,5114,
1897022,1902138,2022-11-02_20-59-51-161819,1902154,5116,
1902176,1907241,2022-11-02_20-59-56-477436,1907257,5065,
1907277,1907320,2022-11-02_21-00-01-607453,1907326,43,
1912352,1917453,2022-11-02_21-00-06-933677,1917463,5101,
1917479,1917529,2022-11-02_21-00-12-053245,1917532,50,
1922576,1927706,2022-11-02_21-00-17-375906,1927723,5130,
1927736,1927755,2022-11-02_21-00-22-521320,1927758,19,
1932819,1937949,2022-11-02_21-00-27-923173,1937965,5130,
1937986,1938065,2022-11-02_21-00-33-076149,1938069,79,
1943053,1943073,2022-11-02_21-00-38-199295,1943076,20,
1948171,1953306,2022-11-02_21-00-43-591104,1953315,5135,
1953333,1953352,2022-11-02_21-00-48-723781,1953355,19,
1958446,1958471,2022-11-02_21-00-53-964329,1958474,25,
1963559,1963579,2022-11-02_21-00-59-186265,1963582,20,
1968679,1973781,2022-11-02_21-01-04-584384,1973797,5102,
1973818,1978889,2022-11-02_21-01-09-805694,1978904,5071,
1978926,1983996,2022-11-02_21-01-15-003893,1984012,5070,
1984033,1984060,2022-11-02_21-01-20-150317,1984065,27,
1989110,1994222,2022-11-02_21-01-25-477581,1994231,5112,
1994244,1994269,2022-11-02_21-01-30-593462,1994273,25,
1999372,1999392,2022-11-02_21-01-35-841840,1999395,20,
2004508,2009608,2022-11-02_21-01-41-243374,2009616,5100,
2009631,2009687,2022-11-02_21-01-46-378217,2009689,56,
2014752,2014862,2022-11-02_21-01-51-688149,2019868,110,
2019880,2019967,2022-11-02_21-01-56-913383,2019972,87,
2025005,2030144,2022-11-02_21-02-02-236192,2030154,5139,
2030166,2035244,2022-11-02_21-02-07-457920,2035253,5078,
2035273,2040390,2022-11-02_21-02-12-767811,2040405,5117,
2040428,2045491,2022-11-02_21-02-17-976487,2045499,5063,
2045516,2045575,2022-11-02_21-02-23-127329,2045577,59,
2050652,2055754,2022-11-02_21-02-28-449995,2055769,5102,
2055791,2060857,2022-11-02_21-02-33-775914,2060865,5066,
2060877,2066005,2022-11-02_21-02-38-889680,2066020,5128,
2066042,0,,2071114,-2066042,
2071136,2076220,2022-11-02_21-02-49-443207,2076236,5084,
2076253,2081329,2022-11-02_21-02-54-691748,2081345,5076,
2081364,2081468,2022-11-02_21-02-59-887757,2086452,104,
2086471,2091593,2022-11-02_21-03-05-211049,2091609,5122,
2091630,2096721,2022-11-02_21-03-10-435035,2096737,5091,
2096754,2096780,2022-11-02_21-03-15-557705,2096783,26,
2101833,2106962,2022-11-02_21-03-20-879440,2106971,5129,
2106983,2112100,2022-11-02_21-03-26-102441,2112116,5117,
2112138,2117201,2022-11-02_21-03-31-428169,2117210,5063,
2117222,2117282,2022-11-02_21-03-36-549095,2117285,60,
2122322,2127445,2022-11-02_21-03-41-873386,2127460,5123,
2127479,2132552,2022-11-02_21-03-47-095718,2132566,5073,
2132587,2137701,2022-11-02_21-03-52-419110,2137710,5114,
2137723,2137782,2022-11-02_21-03-57-540818,2137785,59,
2142821,2147954,2022-11-02_21-04-02-865882,2147971,5133,
2147983,2148004,2022-11-02_21-04-08-008017,2148006,21,
2153066,2153185,2022-11-02_21-04-13-278232,2158207,119,
2158219,2158292,2022-11-02_21-04-18-534351,2158296,73,
2163324,2163391,2022-11-02_21-04-23-754217,2163394,67,
2168425,2168492,2022-11-02_21-04-28-977086,2168495,67,
2173533,2173597,2022-11-02_21-04-34-199699,2173600,64,
2178651,2183759,2022-11-02_21-04-39-524928,2183767,5108,
2183784,2188896,2022-11-02_21-04-44-848819,2188904,5112,
2188923,2189006,2022-11-02_21-04-49-972686,2189008,83,
2194007,2199111,2022-11-02_21-04-55-293721,2199123,5104,
2199145,2199199,2022-11-02_21-05-00-415704,2199202,54,
2204223,2209344,2022-11-02_21-05-05-711019,2209360,5121,
2209380,2214452,2022-11-02_21-05-10-966331,2214468,5072,
2214486,2219560,2022-11-02_21-05-16-286078,2219575,5074,
2219591,2224661,2022-11-02_21-05-21-430732,2224669,5070,
2224682,2224715,2022-11-02_21-05-26-527530,2224718,33,
2229781,2234884,2022-11-02_21-05-31-852756,2234898,5103,
2234918,2240026,2022-11-02_21-05-37-384194,2240035,5108,
2240054,2245133,2022-11-02_21-05-42-397601,2245142,5079,
2245161,2250287,2022-11-02_21-05-47-621825,2250303,5126,
2250315,2255424,2022-11-02_21-05-52-844037,2255432,5109,
2255445,2260548,2022-11-02_21-05-58-066532,2260564,5103,
2260585,2260634,2022-11-02_21-06-03-291995,2260639,49,
2265662,2270794,2022-11-02_21-06-08-617685,2270810,5132,
2270822,2275902,2022-11-02_21-06-13-940265,2275913,5080,
2275932,2281036,2022-11-02_21-06-19-160648,2281046,5104,
2281067,2286180,2022-11-02_21-06-24-384320,2286195,5113,
2286217,2291289,2022-11-02_21-06-29-608515,2291305,5072,
2291325,2296397,2022-11-02_21-06-34-930468,2296412,5072,
2296433,2301505,2022-11-02_21-06-40-153052,2301521,5072,
2301537,2306613,2022-11-02_21-06-45-378336,2306630,5076,
2306651,2311721,2022-11-02_21-06-50-597903,2311734,5070,
2311746,2311767,2022-11-02_21-06-55-627088,2311771,21,
2316831,2316861,2022-11-02_21-07-00-837894,2316867,30,
2321983,2327081,2022-11-02_21-07-06-266334,2327097,5098,
2327117,2332192,2022-11-02_21-07-11-489544,2332208,5075,
2332229,2337301,2022-11-02_21-07-16-813118,2337316,5072,
2337333,2342409,2022-11-02_21-07-22-035337,2342425,5076,
2342444,2347511,2022-11-02_21-07-27-225369,2347519,5067,
2347531,2347556,2022-11-02_21-07-32-277298,2347558,25,
2352630,2352658,2022-11-02_21-07-37-499499,2352661,28,
2357752,2357773,2022-11-02_21-07-42-734842,2357776,21,
2362859,2367974,2022-11-02_21-07-48-045996,2367983,5115,
2367995,2368058,2022-11-02_21-07-53-267667,2368061,63,
2373141,2378271,2022-11-02_21-07-58-594879,2378280,5130,
2378298,2383425,2022-11-02_21-08-03-917497,2383441,5127,
2383460,2388533,2022-11-02_21-08-09-141706,2388546,5073,
2388567,2393640,2022-11-02_21-08-14-394748,2393654,5073,
2393666,2398747,2022-11-02_21-08-19-585580,2398760,5081,
2398782,2403855,2022-11-02_21-08-24-910282,2403870,5073,
2403892,2403995,2022-11-02_21-08-30-048783,2408965,103,
2408986,2414102,2022-11-02_21-08-35-355056,2414112,5116,
2414124,2414177,2022-11-02_21-08-40-476323,2414180,53,
2419223,2424356,2022-11-02_21-08-45-758626,2424366,5133,
2424378,2429460,2022-11-02_21-08-51-023050,2429475,5082,
2429488,2429580,2022-11-02_21-08-56-245340,2429583,92,
2434577,2439690,2022-11-02_21-09-01-467184,2439698,5113,
2439718,2439788,2022-11-02_21-09-06-689791,2439791,70,
2444851,2449953,2022-11-02_21-09-12-026461,2449969,5102,
2449987,2455061,2022-11-02_21-09-17-339415,2455077,5074,
2455098,2455190,2022-11-02_21-09-22-461499,2455193,92,
2460172,2465283,2022-11-02_21-09-27-787796,2465292,5111,
2465311,2470407,2022-11-02_21-09-33-007126,2470422,5096,
2470444,2475514,2022-11-02_21-09-38-232742,2475530,5070,
2475550,2475597,2022-11-02_21-09-43-350402,2475600,47,
2480618,2480699,2022-11-02_21-09-48-573313,2480702,81,
2485745,2485806,2022-11-02_21-09-53-795959,2485813,61,
2490852,2495984,2022-11-02_21-09-59-120434,2495993,5132,
2496005,2501126,2022-11-02_21-10-04-342429,2501142,5121,
2501163,2506238,2022-11-02_21-10-09-670260,2506247,5075,
2506259,2506284,2022-11-02_21-10-14-760791,2506287,25,
2511381,2511408,2022-11-02_21-10-20-010016,2511412,27,
2516502,2516523,2022-11-02_21-10-25-250122,2516526,21,
2521626,2521702,2022-11-02_21-10-30-557400,2521704,76,
2526753,2531885,2022-11-02_21-10-35-884698,2531894,5132,
2531913,2537024,2022-11-02_21-10-41-206445,2537040,5111,
2537062,2537108,2022-11-02_21-10-46-326718,2537112,46,
2542133,2542153,2022-11-02_21-10-51-488758,2542156,20,
2547246,2552372,2022-11-02_21-10-56-875413,2552388,5126,
2552403,2552439,2022-11-02_21-11-02-011204,2552441,36,
2557470,2562606,2022-11-02_21-11-07-320208,2562614,5136,
2562626,2567752,2022-11-02_21-11-12-542870,2567769,5126,
2567789,2572898,2022-11-02_21-11-17-867469,2572909,5109,
2572927,2572947,2022-11-02_21-11-23-000136,2572950,20,
2578016,2583113,2022-11-02_21-11-28-311882,2583122,5097,
2583134,2588254,2022-11-02_21-11-33-534315,2588262,5120,
2588282,2588328,2022-11-02_21-11-38-757681,2588331,46,
2593374,2593428,2022-11-02_21-11-43-979879,2593431,54,
2598482,2603609,2022-11-02_21-11-49-304242,2603620,5127,
2603632,2608758,2022-11-02_21-11-54-526801,2608767,5126,
2608780,2608828,2022-11-02_21-11-59-748498,2608832,48,
2613878,2618980,2022-11-02_21-12-05-073944,2618995,5102,
2619016,2619041,2022-11-02_21-12-10-196716,2619044,25,
2624094,2629196,2022-11-02_21-12-15-519713,2629212,5102,
2629226,2634299,2022-11-02_21-12-20-844473,2634308,5073,
2634321,2639437,2022-11-02_21-12-26-065672,2639446,5116,
2639460,2644544,2022-11-02_21-12-31-186566,2644554,5084,
2644568,2644648,2022-11-02_21-12-36-404908,2644650,80,
2649656,2649676,2022-11-02_21-12-41-560552,2649678,20,
2654763,2659876,2022-11-02_21-12-46-899523,2659884,5113,
2659896,2659944,2022-11-02_21-12-52-079095,2659947,48,
2664996,2670131,2022-11-02_21-12-57-336679,2670146,5135,
2670159,2675274,2022-11-02_21-13-02-624960,2675290,5115,
2675311,2680374,2022-11-02_21-13-07-948559,2680390,5063,
2680410,2685483,2022-11-02_21-13-13-171365,2685498,5073,
2685519,2690590,2022-11-02_21-13-18-393618,2690599,5071,
2690618,2695748,2022-11-02_21-13-23-721545,2695757,5130,
2695769,2700871,2022-11-02_21-13-28-838462,2700879,5102,
2700898,2700967,2022-11-02_21-13-34-057050,2700970,69,
2705991,2711108,2022-11-02_21-13-39-284150,2711123,5117,
2711142,2716215,2022-11-02_21-13-44-608488,2716231,5073,
2716254,2721323,2022-11-02_21-13-49-831888,2721338,5069,
2721359,2726431,2022-11-02_21-13-55-156369,2726444,5072,
2726464,2726561,2022-11-02_21-14-00-276434,2726564,97,
2731565,2731593,2022-11-02_21-14-05-419441,2731595,28,
2736672,2741796,2022-11-02_21-14-10-720768,2741805,5124,
2741823,2741874,2022-11-02_21-14-15-945927,2741877,51,
2746954,2747077,2022-11-02_21-14-21-210100,2752081,123,
2752093,2752112,2022-11-02_21-14-26-422360,2752115,19,
2757217,2762351,2022-11-02_21-14-31-816117,2762363,5134,
2762376,2767458,2022-11-02_21-14-37-038100,2767469,5082,
2767488,2767589,2022-11-02_21-14-42-260008,2767592,101,
2772566,2777689,2022-11-02_21-14-47-584698,2777698,5123,
2777712,2782832,2022-11-02_21-14-52-808442,2782848,5120,
2782868,2782922,2022-11-02_21-14-57-958544,2782925,54,
2787975,2793102,2022-11-02_21-15-03-256182,2793118,5127,
2793138,2798203,2022-11-02_21-15-08-680919,2798212,5065,
2798234,2803310,2022-11-02_21-15-13-799399,2803320,5076,
2803340,2808469,2022-11-02_21-15-19-024075,2808480,5129,
2808493,2813626,2022-11-02_21-15-24-245163,2813637,5133,
2813649,2813703,2022-11-02_21-15-29-468205,2813706,54,
2818738,2818810,2022-11-02_21-15-34-691581,2818813,72,
2823859,2828990,2022-11-02_21-15-39-974726,2828998,5131,
2829011,2829034,2022-11-02_21-15-45-158154,2829037,23,
2834140,2839283,2022-11-02_21-15-50-563818,2839293,5143,
2839305,2839405,2022-11-02_21-15-55-769019,2839408,100,
2844434,2849548,2022-11-02_21-16-01-110824,2849564,5114,
2849581,2849650,2022-11-02_21-16-06-277106,2849653,69,
2854658,2859782,2022-11-02_21-16-11-526336,2859794,5124,
2859812,2859911,2022-11-02_21-16-16-777097,2859914,99,
2864937,2870058,2022-11-02_21-16-22-103252,2870067,5121,
2870079,2875196,2022-11-02_21-16-27-324608,2875205,5117,
2875223,2880339,2022-11-02_21-16-32-648854,2880355,5116,
2880377,2880430,2022-11-02_21-16-37-771666,2880433,53,
2885443,2890555,2022-11-02_21-16-42-991989,2890570,5112,
2890591,2895657,2022-11-02_21-16-48-316726,2895668,5066,
2895688,2900770,2022-11-02_21-16-53-541760,2900786,5082,
2900807,2900830,2022-11-02_21-16-58-660284,2900833,23,
2905884,2905932,2022-11-02_21-17-03-882947,2905937,48,
2911013,2911034,2022-11-02_21-17-09-107717,2911043,21,
2916124,2916142,2022-11-02_21-17-14-337307,2916145,18,
2921256,2921326,2022-11-02_21-17-19-644151,2921329,70,
2926385,2926449,2022-11-02_21-17-24-869009,2926452,64,
2931519,2931554,2022-11-02_21-17-30-102503,2931559,35,
2936653,2936728,2022-11-02_21-17-35-406696,2936731,75,
2941765,2941841,2022-11-02_21-17-40-636755,2941844,76,
2946888,2946968,2022-11-02_21-17-45-875616,2946973,80,
2952011,2952050,2022-11-02_21-17-51-084498,2952053,39,
2957118,2957169,2022-11-02_21-17-56-315851,2957175,51,
2962218,2962238,2022-11-02_21-18-01-515746,2962240,20,
2967357,2967380,2022-11-02_21-18-06-784087,2967383,23,
2972459,2972483,2022-11-02_21-18-12-006948,2972486,24,
2977616,2977645,2022-11-02_21-18-17-296239,2977648,29,
2982724,2987862,2022-11-02_21-18-22-632611,2987877,5138,
2987899,2992958,2022-11-02_21-18-27-953740,2992966,5059,
2992984,2993052,2022-11-02_21-18-33-069589,2993055,68,
2998080,2998099,2022-11-02_21-18-38-240312,2998103,19,
3003196,3003262,2022-11-02_21-18-43-514535,3003264,66,
3008317,3013451,2022-11-02_21-18-48-843722,3013460,5134,
3013472,3018584,2022-11-02_21-18-54-066017,3018600,5112,
3018620,3023684,2022-11-02_21-18-59-391545,3023693,5064,
3023704,3028843,2022-11-02_21-19-04-715725,3028858,5139,
3028871,3028966,2022-11-02_21-19-09-836022,3033948,95,
3033961,3039074,2022-11-02_21-19-15-058503,3039083,5113,
3039096,3044211,2022-11-02_21-19-20-383303,3044226,5115,
3044246,3049319,2022-11-02_21-19-25-605656,3049334,5073,
3049353,3049402,2022-11-02_21-19-30-755203,3049404,49,
3054432,3059565,2022-11-02_21-19-36-051481,3059575,5133,
3059587,3059611,2022-11-02_21-19-41-201267,3059613,24,
3064684,3069786,2022-11-02_21-19-46-597426,3069801,5102,
3069823,3074897,2022-11-02_21-19-51-820172,3074905,5074,
3074918,3080075,2022-11-02_21-19-57-042523,3080084,5157,
3080096,3080123,2022-11-02_21-20-02-192034,3080126,27,
3085194,3085301,2022-11-02_21-20-07-488027,3090298,107,
3090310,3090331,2022-11-02_21-20-12-644284,3090334,21,
3095413,3100558,2022-11-02_21-20-17-932951,3100575,5145,
3100593,3100615,2022-11-02_21-20-23-171272,3100618,22,
3105673,3110782,2022-11-02_21-20-28-480536,3110792,5109,
3110804,3110824,2022-11-02_21-20-33-629624,3110828,20,
3115897,3121028,2022-11-02_21-20-39-027173,3121037,5131,
3121049,3121099,2022-11-02_21-20-44-148127,3121103,50,
3126147,3126205,2022-11-02_21-20-49-371202,3126208,58,
3131260,3131306,2022-11-02_21-20-54-594088,3131310,46,
3136368,3141470,2022-11-02_21-20-59-918787,3141486,5102,
3141501,3141613,2022-11-02_21-21-05-097564,3146607,112,
3146619,3151729,2022-11-02_21-21-10-464630,3151738,5110,
3151757,3156843,2022-11-02_21-21-15-624226,3156859,5086,
3156881,3156922,2022-11-02_21-21-20-807624,3156925,41,
3161957,3167093,2022-11-02_21-21-26-136018,3167102,5136,
3167114,3167138,2022-11-02_21-21-31-279648,3167140,24,
3172202,3172221,2022-11-02_21-21-36-488784,3172224,19,
3177311,3177331,2022-11-02_21-21-41-722506,3177334,20,
3182427,3187546,2022-11-02_21-21-47-124837,3187563,5119,
3187584,3192654,2022-11-02_21-21-52-347659,3192670,5070,
3192691,3192751,2022-11-02_21-21-57-500852,3192754,60,
3197758,3197819,2022-11-02_21-22-02-689468,3197823,61,
3202879,3207979,2022-11-02_21-22-08-014900,3207988,5100,
3208000,3208020,2022-11-02_21-22-13-126629,3208023,20,
3213122,3218250,2022-11-02_21-22-18-459619,3218265,5128,
3218287,3223351,2022-11-02_21-22-23-775056,3223364,5064,
3223385,3223435,2022-11-02_21-22-28-905275,3223438,50,
3228468,3228554,2022-11-02_21-22-34-140807,3228558,86,
3233602,3238737,2022-11-02_21-22-39-452306,3238747,5135,
3238766,0,,3243852,-3238766,
3243874,3248961,2022-11-02_21-22-49-999954,3248976,5087,
3248996,3249044,2022-11-02_21-22-55-124010,3249047,48,
3254064,3259182,2022-11-02_21-23-01-058901,3259198,5118,
3259218,3259242,2022-11-02_21-23-05-567463,3259246,24,
3264297,3269419,2022-11-02_21-23-10-889976,3269438,5122,
3269450,3269472,2022-11-02_21-23-16-033016,3269476,22,
3274590,3279686,2022-11-02_21-23-22-053006,3279694,5096,
3279706,3279752,2022-11-02_21-23-26-556869,3279755,46,
3284829,3284851,2022-11-02_21-23-31-779853,3284855,22,
3289969,3290054,2022-11-02_21-23-37-106783,3290057,85,
3295094,3300225,2022-11-02_21-23-42-430714,3300235,5131,
3300254,3305369,2022-11-02_21-23-47-753470,3305386,5115,
3305408,3310478,2022-11-02_21-23-52-976459,3310494,5070,
3310515,3315579,2022-11-02_21-23-58-199120,3315595,5064,
3315614,3315659,2022-11-02_21-24-03-319877,3315662,45,
3320691,3320770,2022-11-02_21-24-08-542040,3320779,79,
3325812,3325867,2022-11-02_21-24-13-765464,3325870,55,
3330946,3336070,2022-11-02_21-24-19-063210,3336079,5124,
3336092,3336113,2022-11-02_21-24-24-244722,3336116,21,
3341211,3341276,2022-11-02_21-24-29-535259,3341278,65,
3346358,3351506,2022-11-02_21-24-34-859084,3351522,5148,
3351543,3351579,2022-11-02_21-24-40-083232,3351582,36,
3356620,3356672,2022-11-02_21-24-45-304511,3356675,52,
3361750,3361871,2022-11-02_21-24-50-564983,3366889,121,
3366910,3371994,2022-11-02_21-24-55-953824,3372010,5084,
3372031,3377097,2022-11-02_21-25-01-176476,3377109,5066,
3377130,3382225,2022-11-02_21-25-06-398634,3382235,5095,
3382247,3382287,2022-11-02_21-25-11-521798,3382289,40,
3387345,3387406,2022-11-02_21-25-16-768069,3387409,61,
3392453,3397556,2022-11-02_21-25-22-066155,3397569,5103,
3397590,3402664,2022-11-02_21-25-27-390168,3402676,5074,
3402695,3402720,2022-11-02_21-25-32-426580,3402723,25,
3407778,3407805,2022-11-02_21-25-37-633936,3407808,27,
3412885,3418004,2022-11-02_21-25-42-956985,3418012,5119,
3418025,3423144,2022-11-02_21-25-48-283223,3423153,5119,
3423165,3423201,2022-11-02_21-25-53-401025,3423204,36,
3428264,3433385,2022-11-02_21-25-58-725942,3433394,5121,
3433407,3433427,2022-11-02_21-26-03-868457,3433430,20,
3438496,3443622,2022-11-02_21-26-09-170978,3443638,5126,
3443660,3448722,2022-11-02_21-26-14-496938,3448732,5062,
3448751,3453838,2022-11-02_21-26-19-730991,3453853,5087,
3453874,3453910,2022-11-02_21-26-24-839232,3453913,36,
3458954,3459018,2022-11-02_21-26-30-061178,3459021,64,
3464168,3464218,2022-11-02_21-26-35-386353,3464221,50,
3469309,3469331,2022-11-02_21-26-40-622112,3469334,22,
3474415,3479515,2022-11-02_21-26-45-932993,3479524,5100,
3479539,3484668,2022-11-02_21-26-51-258776,3484684,5129,
3484705,3484725,2022-11-02_21-26-56-390160,3484728,20,
3489788,3494916,2022-11-02_21-27-01-703126,3494931,5128,
3494943,3494964,2022-11-02_21-27-06-870951,3494967,21,
3500027,3500046,2022-11-02_21-27-12-081726,3500049,19,
3505159,3510288,2022-11-02_21-27-17-473558,3510299,5129,
3510312,3515432,2022-11-02_21-27-22-695121,3515441,5120,
3515453,3520568,2022-11-02_21-27-27-919799,3520584,5115,
3520605,3520629,2022-11-02_21-27-33-141340,3520631,24,
3525690,3525734,2022-11-02_21-27-38-363579,3525737,44,
3530789,3530814,2022-11-02_21-27-43-558601,3530818,25,
3535906,3541008,2022-11-02_21-27-48-909245,3541019,5102,
3541037,3541062,2022-11-02_21-27-54-048116,3541065,25,
3546122,3551263,2022-11-02_21-27-59-354702,3551273,5141,
3551285,3551341,2022-11-02_21-28-04-576803,3551344,56,
3556508,3561611,2022-11-02_21-28-09-934729,3561626,5103,
3561639,3566719,2022-11-02_21-28-15-227881,3566728,5080,
3566740,3566844,2022-11-02_21-28-20-407183,3571849,104,
3571860,3571881,2022-11-02_21-28-25-599793,3571884,21,
3576960,3582074,2022-11-02_21-28-30-894951,3582082,5114,
3582095,3587218,2022-11-02_21-28-36-219323,3587234,5123,
3587248,3587266,2022-11-02_21-28-41-349915,3587269,18,
3592381,3597489,2022-11-02_21-28-46-665884,3597499,5108,
3597517,3602603,2022-11-02_21-28-51-989473,3602618,5086,
3602640,3607711,2022-11-02_21-28-57-211153,3607728,5071,
3607750,3612812,2022-11-02_21-29-02-433606,3612821,5062,
3612833,3617927,2022-11-02_21-29-07-758659,3617938,5094,
3617957,3623035,2022-11-02_21-29-12-982228,3623048,5078,
3623070,3628138,2022-11-02_21-29-18-205930,3628147,5068,
3628160,3633285,2022-11-02_21-29-23-324465,3633301,5125,
3633323,3638385,2022-11-02_21-29-28-651641,3638394,5062,
3638406,3638465,2022-11-02_21-29-33-769767,3638468,59,
3643531,3648659,2022-11-02_21-29-39-094395,3648668,5128,
3648688,3653804,2022-11-02_21-29-44-418414,3653820,5116,
3653841,3658911,2022-11-02_21-29-49-642652,3658928,5070,
3658950,3664037,2022-11-02_21-29-54-800745,3664053,5087,
3664074,3664187,2022-11-02_21-30-00-090283,3669145,113,
3669165,3674253,2022-11-02_21-30-05-410593,3674264,5088,
3674294,3679360,2022-11-02_21-30-10-633423,3679374,5066,
3679394,3684535,2022-11-02_21-30-15-858269,3684551,5141,
3684565,3684585,2022-11-02_21-30-20-985749,3684588,20,
3689679,3694796,2022-11-02_21-30-26-301237,3694811,5117,
3694832,3694887,2022-11-02_21-30-31-523854,3694890,55,
3699912,3699987,2022-11-02_21-30-36-745096,3699991,75,
3705034,3710168,2022-11-02_21-30-42-072710,3710176,5134,
3710189,3715275,2022-11-02_21-30-47-293487,3715284,5086,
3715296,3720404,2022-11-02_21-30-52-516615,3720413,5108,
3720434,3725511,2022-11-02_21-30-57-840833,3725521,5077,
3725533,3730650,2022-11-02_21-31-02-960855,3730666,5117,
3730683,3735758,2022-11-02_21-31-08-286036,3735773,5075,
3735791,3740866,2022-11-02_21-31-13-542909,3740888,5075,
3740909,3745973,2022-11-02_21-31-18-832679,3745986,5064,
3746005,3746096,2022-11-02_21-31-23-953080,3746099,91,
3751126,3751193,2022-11-02_21-31-29-177071,3751197,67,
3756247,3761363,2022-11-02_21-31-34-502021,3761377,5116,
3761396,3761496,2022-11-02_21-31-39-723543,3761499,100,
3766476,3771578,2022-11-02_21-31-44-915980,3771589,5102,
3771601,3776687,2022-11-02_21-31-50-168887,3776696,5086,
3776708,3776729,2022-11-02_21-31-55-309796,3776732,21,
3781792,3786924,2022-11-02_21-32-00-612481,3786933,5132,
3786945,3787015,2022-11-02_21-32-05-837396,3787018,70,
3792065,3797190,2022-11-02_21-32-11-243255,3797208,5125,
3797220,3797321,2022-11-02_21-32-16-383834,3797324,101,
3802327,3807432,2022-11-02_21-32-21-606062,3807445,5105,
3807464,3812545,2022-11-02_21-32-26-931278,3812560,5081,
3812580,3812616,2022-11-02_21-32-32-051449,3812619,36,
3817651,3822766,2022-11-02_21-32-37-274027,3822781,5115,
3822802,3827873,2022-11-02_21-32-42-597885,3827888,5071,
3827905,3832982,2022-11-02_21-32-47-922011,3832997,5077,
3833013,3833134,2022-11-02_21-32-53-042744,3838090,121,
3838111,3843196,2022-11-02_21-32-58-265375,3843213,5085,
3843227,3843248,2022-11-02_21-33-03-394042,3843251,21,
3848311,3853434,2022-11-02_21-33-08-710138,3853442,5123,
3853454,3858570,2022-11-02_21-33-13-932501,3858585,5116,
3858607,3858677,2022-11-02_21-33-19-182179,3858680,70,
3863719,3868854,2022-11-02_21-33-24-482451,3868863,5135,
3868881,3868984,2022-11-02_21-33-29-738386,3868987,103,
3873967,3874048,2022-11-02_21-33-34-925237,3874050,81,
3879082,3879150,2022-11-02_21-33-40-147259,3879152,68,
3884183,3884203,2022-11-02_21-33-45-320196,3884207,20,
3889301,3894435,2022-11-02_21-33-50-696237,3894441,5134,
3894459,3894504,2022-11-02_21-33-55-855934,3894507,45,
3899547,3904660,2022-11-02_21-34-01-242226,3904669,5113,
3904682,3909799,2022-11-02_21-34-06-362562,3909808,5117,
3909820,3909882,2022-11-02_21-34-11-586527,3909885,62,
3914920,3914974,2022-11-02_21-34-16-807482,3914977,54,
3920028,3920076,2022-11-02_21-34-22-030452,3920080,48,
3925137,3930262,2022-11-02_21-34-27-355272,3930271,5125,
3930284,3930303,2022-11-02_21-34-32-504593,3930307,19,
3935398,3940515,2022-11-02_21-34-37-904814,3940530,5117,
3940552,3940591,2022-11-02_21-34-43-040710,3940594,39,
3945655,3945675,2022-11-02_21-34-48-249493,3945678,20,
3950763,3955862,2022-11-02_21-34-53-674340,3955876,5099,
3955889,3961001,2022-11-02_21-34-58-792412,3961010,5112,
3961029,3961076,2022-11-02_21-35-04-015949,3961079,47,
3966121,