RD,TS_received,TS_sent,AK,RoundTrip,
26553,26571,2022-12-30_15-44-52-142302,26575,18,
31682,31725,2022-12-30_15-44-57-407284,31728,43,
36789,36819,2022-12-30_15-45-02-623715,36823,30,
41898,41926,2022-12-30_15-45-07-854150,41928,28,
47003,47023,2022-12-30_15-45-13-076433,47026,20,
52131,57235,2022-12-30_15-45-18-469794,57248,5104,
57268,57320,2022-12-30_15-45-23-621342,57324,52,
62354,62421,2022-12-30_15-45-28-841892,62424,67,
67463,67533,2022-12-30_15-45-34-066428,67536,70,
72571,72633,2022-12-30_15-45-39-289323,72637,62,
77678,77729,2022-12-30_15-45-44-508660,77732,51,
82787,82830,2022-12-30_15-45-49-734755,82835,43,
87897,87931,2022-12-30_15-45-54-950230,87934,34,
93003,93037,2022-12-30_15-46-00-178949,93039,34,
98102,98121,2022-12-30_15-46-05-382280,98129,19,
103232,103251,2022-12-30_15-46-10-633383,103254,19,
108370,108442,2022-12-30_15-46-15-947394,108445,72,
113478,113549,2022-12-30_15-46-21-173198,113556,71,
118586,118647,2022-12-30_15-46-26-393337,118649,61,
123694,123754,2022-12-30_15-46-31-615283,123757,60,
128825,128854,2022-12-30_15-46-36-838731,128857,29,
133928,139048,2022-12-30_15-46-42-161256,139056,5120,
139072,139150,2022-12-30_15-46-47-383953,139153,78,
144171,144246,2022-12-30_15-46-52-608213,144249,75,
149271,149352,2022-12-30_15-46-57-828805,149355,81,
154378,154398,2022-12-30_15-47-02-999334,154402,20,
159495,159559,2022-12-30_15-47-08-276192,159564,64,
164625,164652,2022-12-30_15-47-13-495787,164654,27,
169776,169796,2022-12-30_15-47-18-754595,169799,20,
174929,174963,2022-12-30_15-47-24-044433,174966,34,
180036,180062,2022-12-30_15-47-29-263250,180065,26,
185169,185194,2022-12-30_15-47-34-511595,185197,25,
190279,190299,2022-12-30_15-47-39-742778,190302,20,
195392,195469,2022-12-30_15-47-45-035253,195471,77,
200494,200565,2022-12-30_15-47-50-258134,200568,71,
205617,210758,2022-12-30_15-47-55-748809,210766,5141,
210782,215901,2022-12-30_15-48-00-941471,215917,5119,
215938,215959,2022-12-30_15-48-06-027809,215962,21,
221007,221028,2022-12-30_15-48-11-215820,221031,21,
226133,226173,2022-12-30_15-48-16-477035,226178,40,
231240,231263,2022-12-30_15-48-21-688703,231266,23,
236369,236476,2022-12-30_15-48-27-021289,241499,107,
241521,241579,2022-12-30_15-48-32-244585,241584,58,
246606,246680,2022-12-30_15-48-37-464983,246683,74,
251732,251793,2022-12-30_15-48-42-691147,251799,61,
256860,256901,2022-12-30_15-48-47-912682,256906,41,
261983,0,,267128,-261983,
267150,267196,2022-12-30_15-48-58-460100,267201,46,
272241,272270,2022-12-30_15-49-03-671831,272273,29,
277377,277396,2022-12-30_15-49-08-908790,277399,19,
282501,282520,2022-12-30_15-49-14-157417,282523,19,
287609,287630,2022-12-30_15-49-19-381420,287633,21,
292733,292807,2022-12-30_15-49-24-680982,292813,74,
297902,297994,2022-12-30_15-49-29-997018,297997,92,
303019,303040,2022-12-30_15-49-35-159327,303043,21,
308132,308207,2022-12-30_15-49-40-447195,308210,75,
313244,313304,2022-12-30_15-49-45-665521,313307,60,
318353,318403,2022-12-30_15-49-50-888155,318406,50,
323496,323515,2022-12-30_15-49-56-125624,323518,19,
328618,328638,2022-12-30_15-50-01-363705,328641,20,
333795,333815,2022-12-30_15-50-06-659947,333818,20,
338899,338918,2022-12-30_15-50-11-889047,338923,19,
344006,344026,2022-12-30_15-50-17-127103,344029,20,
349114,349133,2022-12-30_15-50-22-351648,349137,19,
354254,354312,2022-12-30_15-50-27-650869,354315,58,
359397,359418,2022-12-30_15-50-32-875049,359420,21,
364516,364543,2022-12-30_15-50-38-124041,364546,27,
369623,369643,2022-12-30_15-50-43-343052,369646,20,
374732,374752,2022-12-30_15-50-48-574929,374755,20,
379862,379916,2022-12-30_15-50-53-866690,379919,54,
385002,385021,2022-12-30_15-50-59-099652,385024,19,
390140,390160,2022-12-30_15-51-04-358533,390163,20,
395253,395273,2022-12-30_15-51-09-585610,395276,20,
400388,400412,2022-12-30_15-51-14-848452,400415,24,
405494,405518,2022-12-30_15-51-20-079228,405521,24,
410598,410713,2022-12-30_15-51-25-402691,415705,115,
415726,415816,2022-12-30_15-51-30-626062,415819,90,
420844,420864,2022-12-30_15-51-35-794103,420867,20,
425965,425986,2022-12-30_15-51-41-037317,425989,21,
431083,431124,2022-12-30_15-51-46-293323,431127,41,
436190,436225,2022-12-30_15-51-51-518314,436228,35,
441324,441422,2022-12-30_15-51-56-832059,441425,98,
446479,446538,2022-12-30_15-52-02-070999,446543,59,
451598,451629,2022-12-30_15-52-07-288714,451638,31,
456702,456724,2022-12-30_15-52-12-508511,456728,22,
461841,461860,2022-12-30_15-52-17-764915,461863,19,
467004,467031,2022-12-30_15-52-23-058579,467034,27,
472152,472238,2022-12-30_15-52-28-382387,472243,86,
477258,477326,2022-12-30_15-52-33-603355,477332,68,
482364,482431,2022-12-30_15-52-38-825400,482434,67,
487466,487488,2022-12-30_15-52-44-000766,487492,22,
492618,492643,2022-12-30_15-52-49-275750,492646,25,
497727,497833,2022-12-30_15-52-54-591761,502852,106,
502865,502883,2022-12-30_15-52-59-766992,502886,18,
507976,508027,2022-12-30_15-53-05-038219,508030,51,
513116,513138,2022-12-30_15-53-10-264739,513140,22,
518224,518250,2022-12-30_15-53-15-494891,518253,26,
523362,523431,2022-12-30_15-53-20-802425,523435,69,
528462,528540,2022-12-30_15-53-26-031833,528545,78,
533574,533594,2022-12-30_15-53-31-199955,533597,20,
538691,538733,2022-12-30_15-53-36-469023,538736,42,
543921,543941,2022-12-30_15-53-41-804979,543944,20,
549025,549143,2022-12-30_15-53-47-126824,554162,118,
554176,554240,2022-12-30_15-53-52-349347,554242,64,
559273,559293,2022-12-30_15-53-57-529184,559297,20,
564427,564447,2022-12-30_15-54-02-799245,564450,20,
569581,569600,2022-12-30_15-54-08-075348,569603,19,
574689,574743,2022-12-30_15-54-13-341753,574746,54,
579847,579867,2022-12-30_15-54-18-583847,579869,20,
584997,585057,2022-12-30_15-54-23-891036,585062,60,
590103,590153,2022-12-30_15-54-29-112347,590159,50,
595214,595259,2022-12-30_15-54-34-336977,595262,45,
600321,600358,2022-12-30_15-54-39-556836,600361,37,
605431,605450,2022-12-30_15-54-44-778597,605453,19,
610557,610583,2022-12-30_15-54-50-029349,610585,26,
615664,615752,2022-12-30_15-54-55-323242,615757,88,
620788,620808,2022-12-30_15-55-00-509241,620811,20,
625897,625917,2022-12-30_15-55-05-738077,625920,20,
631028,631048,2022-12-30_15-55-10-988972,631063,20,
636167,636187,2022-12-30_15-55-16-249846,636190,20,
641289,641362,2022-12-30_15-55-21-543813,641367,73,
646426,646464,2022-12-30_15-55-26-764857,646467,38,
651524,651561,2022-12-30_15-55-31-982696,651564,37,
656651,656671,2022-12-30_15-55-37-214678,656674,20,
661804,661877,2022-12-30_15-55-42-534468,661882,73,
666936,666974,2022-12-30_15-55-47-759315,666980,38,
672066,672085,2022-12-30_15-55-52-996868,672088,19,
677184,677205,2022-12-30_15-55-58-243682,677208,21,
682305,682365,2022-12-30_15-56-03-529506,682368,60,
687440,687460,2022-12-30_15-56-08-742576,687463,20,
692560,692579,2022-12-30_15-56-13-987397,692583,19,
697681,697702,2022-12-30_15-56-19-221227,697705,21,
702820,702877,2022-12-30_15-56-24-519254,702882,57,
707964,707986,2022-12-30_15-56-29-757043,707988,22,
713074,713095,2022-12-30_15-56-34-982067,713097,21,
718183,718203,2022-12-30_15-56-40-207945,718206,20,
723296,723315,2022-12-30_15-56-45-446064,723317,19,
728411,728491,2022-12-30_15-56-50-738090,728495,80,
733694,733787,2022-12-30_15-56-56-161768,733790,93,
738801,738822,2022-12-30_15-57-01-315566,738824,21,
743945,743985,2022-12-30_15-57-06-606604,743988,40,
749053,749091,2022-12-30_15-57-11-823426,749094,38,
754160,754184,2022-12-30_15-57-17-051628,754187,24,
759259,759279,2022-12-30_15-57-22-272431,759284,20,
764380,764401,2022-12-30_15-57-27-511204,764403,21,
769511,769589,2022-12-30_15-57-32-821331,769595,78,
774613,774686,2022-12-30_15-57-38-042721,774689,73,
779727,779779,2022-12-30_15-57-43-257714,779782,52,
784856,784895,2022-12-30_15-57-48-488485,784898,39,
789964,789988,2022-12-30_15-57-53-710361,789993,24,
795101,795122,2022-12-30_15-57-58-963125,795125,21,
800221,800240,2022-12-30_15-58-04-204057,800243,19,
805341,805399,2022-12-30_15-58-09-484285,805403,58,
810474,810498,2022-12-30_15-58-14-702793,810501,24,
815612,815630,2022-12-30_15-58-19-964679,815633,18,
820732,820752,2022-12-30_15-58-25-202556,820755,20,
825871,825891,2022-12-30_15-58-30-472342,825894,20,
830981,830999,2022-12-30_15-58-35-697805,831002,18,
836101,836121,2022-12-30_15-58-40-938126,836123,20,
841218,841290,2022-12-30_15-58-46-242581,841293,72,
846327,846405,2022-12-30_15-58-51-468097,846410,78,
851444,851507,2022-12-30_15-58-56-687420,851513,63,
856554,856595,2022-12-30_15-59-01-909904,856598,41,
861665,861704,2022-12-30_15-59-07-133290,861707,39,
866876,866900,2022-12-30_15-59-12-457566,866903,24,
871991,872021,2022-12-30_15-59-17-691041,872027,30,
877096,877117,2022-12-30_15-59-22-921038,877119,21,
882266,882297,2022-12-30_15-59-28-227173,882303,31,
887374,887412,2022-12-30_15-59-33-449840,887415,38,
892479,892500,2022-12-30_15-59-38-670404,892503,21,
897599,897620,2022-12-30_15-59-43-906344,897623,21,
902704,902724,2022-12-30_15-59-49-132292,902727,20,
907837,907900,2022-12-30_15-59-54-433557,907902,63,
912941,912961,2022-12-30_15-59-59-611645,912964,20,
918057,918112,2022-12-30_16-00-04-885722,918116,55,
923167,923221,2022-12-30_16-00-10-116600,923224,54,
928275,928319,2022-12-30_16-00-15-332181,928324,44,
933383,933414,2022-12-30_16-00-20-554495,933419,31,
938499,938519,2022-12-30_16-00-25-793933,938521,20,
943606,943629,2022-12-30_16-00-31-016615,943631,23,
948752,948817,2022-12-30_16-00-36-326559,948820,65,
953859,953904,2022-12-30_16-00-41-544694,953907,45,
958959,958978,2022-12-30_16-00-46-733961,958981,19,
964076,964121,2022-12-30_16-00-51-992490,964126,45,
969181,969216,2022-12-30_16-00-57-212600,969219,35,
974311,974330,2022-12-30_16-01-02-455108,974334,19,
979429,979448,2022-12-30_16-01-07-690828,979451,19,
984570,984626,2022-12-30_16-01-12-984330,984629,56,
989676,989725,2022-12-30_16-01-18-206416,989728,49,
994785,994825,2022-12-30_16-01-23-428956,994829,40,
999884,999923,2022-12-30_16-01-28-650212,999926,39,
1005011,1005031,2022-12-30_16-01-33-881732,1005034,20,
1010171,1010215,2022-12-30_16-01-39-191586,1010219,44,
1015270,1015290,2022-12-30_16-01-44-381683,1015293,20,
1020387,1020424,2022-12-30_16-01-49-642441,1020427,37,
1025495,1025532,2022-12-30_16-01-54-865656,1025535,37,
1030602,1030630,2022-12-30_16-02-00-088595,1030636,28,
1035747,1035766,2022-12-30_16-02-05-350914,1035769,19,
1040864,1040919,2022-12-30_16-02-10-624756,1040921,55,
1045971,1046036,2022-12-30_16-02-15-862180,1046041,65,
1051082,1051138,2022-12-30_16-02-21-083425,1051143,56,
1056217,1056238,2022-12-30_16-02-26-304568,1056240,21,
1061351,1061427,2022-12-30_16-02-31-628446,1061430,76,
1066469,
1071598,1076801,2022-12-30_16-02-42-264339,1076806,5203,
1076806,1076840,2022-12-30_16-02-47-398566,1076844,34,
1081942,1082024,2022-12-30_16-02-52-711966,1082027,82,
1087071,1087090,2022-12-30_16-02-57-897425,1087094,19,
1092185,1092204,2022-12-30_16-03-03-132977,1092207,19,
1097328,1097347,2022-12-30_16-03-08-402791,1097350,19,
1102478,1102537,2022-12-30_16-03-13-715199,1102540,59,
1107624,1107645,2022-12-30_16-03-18-942992,1107647,21,
1112755,1112774,2022-12-30_16-03-24-203418,1112777,19,
1117879,1117936,2022-12-30_16-03-29-484594,1117941,57,
1123023,1123043,2022-12-30_16-03-34-710642,1123046,20,
1128152,1128170,2022-12-30_16-03-39-962294,1128173,18,
1133272,1133341,2022-12-30_16-03-45-257121,1133345,69,
1138393,1138414,2022-12-30_16-03-50-451469,1138416,21,
1143510,1143543,2022-12-30_16-03-55-699100,1143546,33,
1148616,1148647,2022-12-30_16-04-00-921274,1148652,31,
1153764,1153784,2022-12-30_16-04-06-192036,1153787,20,
1158881,1158939,2022-12-30_16-04-11-465012,1158942,58,
1164010,1164036,2022-12-30_16-04-16-690311,1164039,26,
1169120,1169142,2022-12-30_16-04-21-913258,1169146,22,
1174317,1174345,2022-12-30_16-04-27-237239,1174351,28,
1179417,1179436,2022-12-30_16-04-32-452588,1179439,19,
1184549,1184568,2022-12-30_16-04-37-695616,1184570,19,
1189667,1189687,2022-12-30_16-04-42-939801,1189690,20,
1194774,1194799,2022-12-30_16-04-48-171491,1194802,25,
1199885,1199907,2022-12-30_16-04-53-403543,1199910,22,
1205013,1205053,2022-12-30_16-04-58-677520,1205055,40,
1210110,1210130,2022-12-30_16-05-03-881857,1210134,20,
1215239,1215265,2022-12-30_16-05-09-125812,1215268,26,
1220377,1220452,2022-12-30_16-05-14-446422,1220458,75,
1225519,1225556,2022-12-30_16-05-19-670568,1225562,37,
1230657,1230676,2022-12-30_16-05-24-910421,1230679,19,
1235766,1235786,2022-12-30_16-05-30-137242,1235789,20,
1240898,1240919,2022-12-30_16-05-35-389750,1240921,21,
1246046,1246078,2022-12-30_16-05-40-661819,1246083,32,
1251173,1251194,2022-12-30_16-05-45-910245,1251197,21,
1256289,1256357,2022-12-30_16-05-51-200576,1256361,68,
1261391,1261476,2022-12-30_16-05-56-430750,1261478,85,
1266500,1266520,2022-12-30_16-06-01-605033,1266522,20,
1271616,1271669,2022-12-30_16-06-06-869316,1271671,53,
1276724,1276769,2022-12-30_16-06-12-097405,1276773,45,
1281862,1281881,2022-12-30_16-06-17-330871,1281885,19,
1286970,1286989,2022-12-30_16-06-22-561070,1286993,19,
1292105,1292125,2022-12-30_16-06-27-817890,1292129,20,
1297256,1302380,2022-12-30_16-06-33-330710,1302382,5124,
1302383,1302404,2022-12-30_16-06-38-340937,1302408,21,
1307490,1307571,2022-12-30_16-06-43-636837,1307574,81,
1312598,1312679,2022-12-30_16-06-48-859608,1312682,81,
1317716,1317779,2022-12-30_16-06-54-083997,1317784,63,
1322824,1322883,2022-12-30_16-06-59-304149,1322886,59,
1327931,1327985,2022-12-30_16-07-04-526507,1327988,54,
1333039,1333083,2022-12-30_16-07-09-748473,1333086,44,
1338147,1338188,2022-12-30_16-07-14-970941,1338192,41,
1343256,1343286,2022-12-30_16-07-20-194551,1343290,30,
1348388,1348407,2022-12-30_16-07-25-444644,1348410,19,
1353496,1353515,2022-12-30_16-07-30-666608,1353518,19,
1358689,1358782,2022-12-30_16-07-36-065710,1358784,93,
1363806,1363829,2022-12-30_16-07-41-234720,1363832,23,
1368962,1368987,2022-12-30_16-07-46-511343,1368990,25,
1374068,1374088,2022-12-30_16-07-51-733634,1374091,20,
1379210,1379285,2022-12-30_16-07-57-059482,1379288,75,
1384409,1384490,2022-12-30_16-08-02-385169,1384493,81,
1389517,1389595,2022-12-30_16-08-07-598091,1389597,78,
1394616,1394636,2022-12-30_16-08-12-768042,1394639,20,
1399767,1399801,2022-12-30_16-08-18-053704,1399804,34,
1404875,1404901,2022-12-30_16-08-23-268918,1404905,26,
1409988,1410093,2022-12-30_16-08-28-597681,1410096,105,
1415131,1415189,2022-12-30_16-08-33-821763,1415194,58,
1420243,1420305,2022-12-30_16-08-39-044836,1420309,62,
1425350,1425399,2022-12-30_16-08-44-267059,1425401,49,
1430458,1430495,2022-12-30_16-08-49-489728,1430498,37,
1435566,1435604,2022-12-30_16-08-54-713484,1435609,38,
1440665,1440684,2022-12-30_16-08-59-913901,1440687,19,
1445821,1445840,2022-12-30_16-09-05-198784,1445843,19,
1450977,1451007,2022-12-30_16-09-10-481579,1451010,30,
1456087,1461190,2022-12-30_16-09-15-807086,1461200,5103,
1461214,1461299,2022-12-30_16-09-21-015556,1461303,85,
1466301,1466331,2022-12-30_16-09-26-161088,1466337,30,
1471407,1471429,2022-12-30_16-09-31-392517,1471431,22,
1476522,1476611,2022-12-30_16-09-36-697116,1476614,89,
1481633,1481652,2022-12-30_16-09-41-866267,1481655,19,
1486741,1486766,2022-12-30_16-09-47-100013,1486769,25,
1491871,1491914,2022-12-30_16-09-52-364563,1491917,43,
1496977,1497016,2022-12-30_16-09-57-586214,1497018,39,
1502083,1502107,2022-12-30_16-10-02-808249,1502110,24,
1507192,1507217,2022-12-30_16-10-08-032249,1507219,25,
1512300,1512319,2022-12-30_16-10-13-256314,1512322,19,
1517432,1517452,2022-12-30_16-10-18-508250,1517455,20,
1522546,1522622,2022-12-30_16-10-23-799107,1522625,76,
1527655,1527722,2022-12-30_16-10-29-022846,1527724,67,
1532804,1532823,2022-12-30_16-10-34-247194,1532826,19,
1537920,1537940,2022-12-30_16-10-39-482343,1537943,20,
1543041,1543129,2022-12-30_16-10-44-792996,1543135,88,
1548177,1548219,2022-12-30_16-10-50-017191,1548222,42,
1553284,1553320,2022-12-30_16-10-55-236675,1553323,36,
1558384,1558403,2022-12-30_16-11-00-440760,1558405,19,
1563500,1563525,2022-12-30_16-11-05-677927,1563527,25,
1568605,1568626,2022-12-30_16-11-10-904724,1568629,21,
1573711,1573730,2022-12-30_16-11-16-130172,1573733,19,
1578843,1578863,2022-12-30_16-11-21-379341,1578866,20,
1583965,1584032,2022-12-30_16-11-26-675393,1584037,67,
1589104,1589133,2022-12-30_16-11-31-897596,1589137,29,
1594201,1594221,2022-12-30_16-11-37-100633,1594230,20,
1599464,1599485,2022-12-30_16-11-42-494282,1599487,21,
1604581,1604627,2022-12-30_16-11-47-761299,1604630,46,
1609718,1609737,2022-12-30_16-11-52-992685,1609740,19,
1614864,1614936,2022-12-30_16-11-58-319939,1614941,72,
1619994,1620032,2022-12-30_16-12-03-539771,1620034,38,
1625129,1625149,2022-12-30_16-12-08-771894,1625151,20,
1630237,1630342,2022-12-30_16-12-14-085764,1635364,105,
1635376,1635397,2022-12-30_16-12-19-265051,1635399,21,
1640503,1640524,2022-12-30_16-12-24-509999,1640527,21,
1645633,1645653,2022-12-30_16-12-29-760956,1645656,20,
1650779,1650846,2022-12-30_16-12-35-079385,1650849,67,
1655903,1655960,2022-12-30_16-12-40-301138,1655966,57,
1661010,1661048,2022-12-30_16-12-45-523931,1661051,38,
1666141,1666163,2022-12-30_16-12-50-758430,1666165,22,
1671264,1671284,2022-12-30_16-12-56-003574,1671287,20,
1676373,1676450,2022-12-30_16-13-01-294476,1676453,77,
1681488,1681543,2022-12-30_16-13-06-515246,1681545,55,
1686609,1686648,2022-12-30_16-13-11-740286,1686651,39,
1691718,1691753,2022-12-30_16-13-16-962724,1691756,35,
1696825,1696850,2022-12-30_16-13-22-185140,1696853,25,
1701929,1701953,2022-12-30_16-13-27-408153,1701955,24,
1707034,1707155,2022-12-30_16-13-32-730456,1712155,121,
1712166,1712186,2022-12-30_16-13-37-883951,1712189,20,
1717266,1717285,2022-12-30_16-13-43-107830,1717288,19,
1722443,1722462,2022-12-30_16-13-48-402901,1722465,19,
1727580,1727601,2022-12-30_16-13-53-667642,1727605,21,
1732740,1732759,2022-12-30_16-13-58-944450,1732762,19,
1737872,1737892,2022-12-30_16-14-04-198875,1737895,20,
1742987,1743057,2022-12-30_16-14-09-492368,1743059,70,
1748097,1748159,2022-12-30_16-14-14-716359,1748164,62,
1753204,1753255,2022-12-30_16-14-19-938702,1753260,51,
1758304,1758324,2022-12-30_16-14-25-124726,1758327,20,
1763421,1763460,2022-12-30_16-14-30-382193,1763463,39,
1768529,1768563,2022-12-30_16-14-35-607528,1768566,34,
1773637,1773667,2022-12-30_16-14-40-822879,1773670,30,
1778742,1778765,2022-12-30_16-14-46-049025,1778768,23,
1783854,1783874,2022-12-30_16-14-51-284069,1783877,20,
1788964,1788984,2022-12-30_16-14-56-512725,1788987,20,
1794108,1794128,2022-12-30_16-15-01-781367,1794131,20,
1799226,1799268,2022-12-30_16-15-07-042441,1799271,42,
1804332,1804374,2022-12-30_16-15-12-265747,1804377,42,
1809434,1809453,2022-12-30_16-15-17-468942,1809456,19,
1814580,1814601,2022-12-30_16-15-22-737448,1814603,21,
1819688,1819771,2022-12-30_16-15-28-034844,1819776,83,
1824797,1824877,2022-12-30_16-15-33-256997,1824883,80,
1829905,1829926,2022-12-30_16-15-38-424962,1829928,21,
1835021,1835076,2022-12-30_16-15-43-701300,1835081,55,
1840159,1840179,2022-12-30_16-15-48-923562,1840181,20,
1845261,1845287,2022-12-30_16-15-54-157369,1845290,26,
1850420,1850479,2022-12-30_16-15-59-470605,1850482,59,
1855557,1855588,2022-12-30_16-16-04-695355,1855590,31,
1860659,1860686,2022-12-30_16-16-09-926845,1860689,27,
1865794,1865816,2022-12-30_16-16-15-176256,1865818,22,
1870907,1870980,2022-12-30_16-16-20-464465,1870983,73,
1876020,1876083,2022-12-30_16-16-25-685361,1876086,63,
1881133,1881180,2022-12-30_16-16-30-909758,1881183,47,
1886244,1886263,2022-12-30_16-16-36-110241,1886267,19,
1891362,1891383,2022-12-30_16-16-41-350426,1891385,21,
1896467,1896488,2022-12-30_16-16-46-581332,1896491,21,
1901616,1901691,2022-12-30_16-16-51-904173,1901696,75,
1906760,1906797,2022-12-30_16-16-57-124862,1906802,37,
1911907,1911993,2022-12-30_16-17-02-448019,1911996,86,
1917044,1917090,2022-12-30_16-17-07-665555,1917093,46,
1922184,1922203,2022-12-30_16-17-12-898225,1922206,19,
1927349,1927392,2022-12-30_16-17-18-219368,1927397,43,
1932489,1932509,2022-12-30_16-17-23-452437,1932512,20,
1937603,1937622,2022-12-30_16-17-28-687521,1937626,19,
1942718,1942789,2022-12-30_16-17-33-980177,1942792,71,
1947818,1947841,2022-12-30_16-17-39-150021,1947843,23,
1952949,1953003,2022-12-30_16-17-44-435431,1953008,54,
1958079,1958099,2022-12-30_16-17-49-659119,1958102,20,
1963204,1963224,2022-12-30_16-17-54-902815,1963227,20,
1968335,1968407,2022-12-30_16-18-00-206696,1968413,72,
1973466,1973494,2022-12-30_16-18-05-425097,1973498,28,
1978575,1978608,2022-12-30_16-18-10-648522,1978610,33,
1983676,1983707,2022-12-30_16-18-15-866584,1983710,31,
1988794,1988813,2022-12-30_16-18-21-106369,1988817,19,
1993963,1993994,2022-12-30_16-18-26-411665,1993997,31,
1999089,1999109,2022-12-30_16-18-31-648423,1999112,20,
2004232,2004330,2022-12-30_16-18-36-970663,2004335,98,
2009360,2009401,2022-12-30_16-18-42-188941,2009405,41,
2014467,2014506,2022-12-30_16-18-47-406413,2014511,39,
2019580,2019605,2022-12-30_16-18-52-626478,2019608,25,
2024688,2024709,2022-12-30_16-18-57-854483,2024713,21,
2029810,2029829,2022-12-30_16-19-03-097832,2029832,19,
2034936,2034957,2022-12-30_16-19-08-344981,2034961,21,
2040055,2040123,2022-12-30_16-19-13-627249,2040128,68,
2045161,2045220,2022-12-30_16-19-18-848540,2045222,59,
2050301,2050320,2022-12-30_16-19-24-074161,2050323,19,
2055425,2055445,2022-12-30_16-19-29-331639,2055448,20,
2060546,2060617,2022-12-30_16-19-34-618415,2060620,71,
2065694,2065712,2022-12-30_16-19-39-842689,2065715,18,
2070828,2070849,2022-12-30_16-19-45-104034,2070852,21,
2075949,2076016,2022-12-30_16-19-50-388025,2076020,67,
2081068,2081113,2022-12-30_16-19-55-610973,2081117,45,
2086185,2086219,2022-12-30_16-20-00-834624,2086222,34,
2091293,2091321,2022-12-30_16-20-06-054081,2091324,28,
2096404,2096425,2022-12-30_16-20-11-285073,2096428,21,
2101524,2101544,2022-12-30_16-20-16-525025,2101547,20,
2106645,2106665,2022-12-30_16-20-21-768293,2106667,20,
2111765,2111829,2022-12-30_16-20-27-049031,2111833,64,
2116874,2116926,2022-12-30_16-20-32-269463,2116929,52,
2121998,2122017,2022-12-30_16-20-37-482052,2122020,19,
2127113,2127133,2022-12-30_16-20-42-718094,2127136,20,
2132221,2132242,2022-12-30_16-20-47-950314,2132245,21,
2137364,2137383,2022-12-30_16-20-53-214926,2137386,19,
2142479,2142529,2022-12-30_16-20-58-483877,2142532,50,
2147588,2147635,2022-12-30_16-21-03-706317,2147639,47,
2152687,2152727,2022-12-30_16-21-08-927424,2152730,40,
2157834,2157854,2022-12-30_16-21-14-171822,2157857,20,
2162941,2162962,2022-12-30_16-21-19-401889,2162964,21,
2168095,2168123,2022-12-30_16-21-24-697939,2168126,28,
2173203,2173238,2022-12-30_16-21-29-919707,2173241,35,
2178312,2178334,2022-12-30_16-21-35-143774,2178339,22,
2183463,2183534,2022-12-30_16-21-40-471501,2183539,71,
2188596,2188630,2022-12-30_16-21-45-690577,2188633,34,
2193694,2193734,2022-12-30_16-21-50-913953,2193737,40,
2198810,2198932,2022-12-30_16-21-56-238120,2203930,122,
2203942,2203962,2022-12-30_16-22-01-385245,2203965,20,
2209049,2209135,2022-12-30_16-22-06-683280,2209140,86,
2214170,2214230,2022-12-30_16-22-11-905741,2214235,60,
2219269,2219290,2022-12-30_16-22-17-078056,2219292,21,
2224401,2224421,2022-12-30_16-22-22-331611,2224424,20,
2229511,2229542,2022-12-30_16-22-27-573271,2229545,31,
2234609,2234632,2022-12-30_16-22-32-785052,2234635,23,
2239765,2239786,2022-12-30_16-22-38-054181,2239789,21,
2244915,2244952,2022-12-30_16-22-43-343242,2244955,37,
2250026,2250050,2022-12-30_16-22-48-564281,2250053,24,
2255137,2255157,2022-12-30_16-22-53-794346,2255160,20,
2260247,2260266,2022-12-30_16-22-59-030891,2260270,19,
2265375,2265395,2022-12-30_16-23-04-275116,2265399,20,
2270489,2270559,2022-12-30_16-23-09-558452,2270562,70,
2275591,2275610,2022-12-30_16-23-14-727592,2275613,19,
2280739,2280763,2022-12-30_16-23-20-005496,2280766,24,
2285847,2285870,2022-12-30_16-23-25-225741,2285873,23,
2290953,2290975,2022-12-30_16-23-30-459387,2290977,22,
2296091,2296110,2022-12-30_16-23-35-712747,2296112,19,
2301199,2301270,2022-12-30_16-23-40-995452,2301273,71,
2306340,2306376,2022-12-30_16-23-46-218047,2306382,36,
2311448,2311473,2022-12-30_16-23-51-440173,2311476,25,
2316552,2316572,2022-12-30_16-23-56-662229,2316575,20,
2321684,2321771,2022-12-30_16-24-01-987125,2321773,87,
2326792,2326811,2022-12-30_16-24-07-150740,2326814,19,
2331921,2331973,2022-12-30_16-24-12-432638,2331976,52,
2337052,2337074,2022-12-30_16-24-17-656019,2337077,22,
2342151,2342194,2022-12-30_16-24-22-898096,2342197,43,
2347274,2347294,2022-12-30_16-24-28-117254,2347298,20,
2352401,2352477,2022-12-30_16-24-33-424841,2352480,76,
2357543,2357570,2022-12-30_16-24-38-646057,2357573,27,
2362650,2362678,2022-12-30_16-24-43-865449,2362681,28,
2367752,2367772,2022-12-30_16-24-49-090904,2367775,20,
2372884,2372904,2022-12-30_16-24-54-345913,2372906,20,
2378025,2378079,2022-12-30_16-24-59-641512,2378084,54,
2383166,2383185,2022-12-30_16-25-04-879131,2383188,19,
2388286,2388364,2022-12-30_16-25-10-187202,2388367,78,
2393400,2393420,2022-12-30_16-25-15-355511,2393423,20,
2398515,2398572,2022-12-30_16-25-20-631226,2398575,57,
2403626,2403664,2022-12-30_16-25-25-852820,2403667,38,
2408747,2408770,2022-12-30_16-25-31-077477,2408773,23,
2413880,2413899,2022-12-30_16-25-36-333132,2413902,19,
2418991,2419011,2022-12-30_16-25-41-566492,2419014,20,
2424103,2424123,2022-12-30_16-25-46-800096,2424126,20,
2429220,2429280,2022-12-30_16-25-52-070292,2429285,60,
2434329,2434358,2022-12-30_16-25-57-285353,2434362,29,
2439436,2439468,2022-12-30_16-26-02-514202,2439471,32,
2444594,2444671,2022-12-30_16-26-07-839811,2444676,77,
2449719,2449765,2022-12-30_16-26-13-061904,2449770,46,
2454861,2454882,2022-12-30_16-26-18-303896,2454885,21,
2459973,2459994,2022-12-30_16-26-23-536351,2460002,21,
2465081,2465160,2022-12-30_16-26-28-830407,2465164,79,
2470217,2470268,2022-12-30_16-26-34-054127,2470271,51,
2475346,2475366,2022-12-30_16-26-39-282756,2475369,20,
2480492,2480568,2022-12-30_16-26-44-603593,2480573,76,
2485607,2485642,2022-12-30_16-26-49-802159,2485645,35,
2490743,2490764,2022-12-30_16-26-55-049838,2490766,21,
2495887,2495951,2022-12-30_16-27-00-364137,2495954,64,
2501011,2501031,2022-12-30_16-27-05-559401,2501034,20,
2506139,2506160,2022-12-30_16-27-10-823247,2506163,21,
2511274,2511299,2022-12-30_16-27-16-082471,2511301,25,
2516381,2516400,2022-12-30_16-27-21-304703,2516404,19,
2521500,2521563,2022-12-30_16-27-26-586616,2521568,63,
2526626,2526654,2022-12-30_16-27-31-806293,2526657,28,
2531758,2531779,2022-12-30_16-27-37-049946,2531782,21,
2536995,2537054,2022-12-30_16-27-42-457639,2537059,59,
2542109,2542129,2022-12-30_16-27-47-655424,2542132,20,
2547225,2547260,2022-12-30_16-27-52-903179,2547265,35,
2552331,2552355,2022-12-30_16-27-58-124732,2552358,24,
2557472,2557560,2022-12-30_16-28-03-450889,2557564,88,
2562585,2562659,2022-12-30_16-28-08-672740,2562664,74,
2567682,2567746,2022-12-30_16-28-13-893847,2567750,64,
2572799,2572857,2022-12-30_16-28-19-118012,2572862,58,
2577908,2577954,2022-12-30_16-28-24-340591,2577960,46,
2583016,2583050,2022-12-30_16-28-29-562225,2583053,34,
2588125,2588153,2022-12-30_16-28-34-783343,2588156,28,
2593226,2593254,2022-12-30_16-28-40-006490,2593257,28,
2598336,2603452,2022-12-30_16-28-45-332417,2603461,5116,
2603475,2603558,2022-12-30_16-28-50-555761,2603561,83,
2608571,2608671,2022-12-30_16-28-55-777083,2608675,100,
2613671,2613691,2022-12-30_16-29-00-927406,2613694,20,
2618780,2618803,2022-12-30_16-29-06-159633,2618805,23,
2623898,2623958,2022-12-30_16-29-11-435991,2623961,60,
2629006,2629056,2022-12-30_16-29-16-660146,2629059,50,
2634113,2634175,2022-12-30_16-29-21-890515,2634180,62,
2639221,2639259,2022-12-30_16-29-27-096448,2639262,38,
2644330,2644361,2022-12-30_16-29-32-326797,2644364,31,
2649444,2649474,2022-12-30_16-29-37-557082,2649477,30,
2654550,2654581,2022-12-30_16-29-42-783607,2654584,31,
2659680,2659702,2022-12-30_16-29-48-027587,2659705,22,
2664787,2664808,2022-12-30_16-29-53-251256,2664810,21,
2669918,2669980,2022-12-30_16-29-58-543729,2669983,62,
2675027,2675086,2022-12-30_16-30-03-770173,2675092,59,
2680125,2680146,2022-12-30_16-30-08-951532,2680149,21,
2685281,2685308,2022-12-30_16-30-14-237265,2685310,27,
2690416,2690435,2022-12-30_16-30-19-489605,2690438,19,
2695532,2695591,2022-12-30_16-30-24-763865,2695597,59,
2700640,2700686,2022-12-30_16-30-29-982018,2700689,46,
2705749,2705797,2022-12-30_16-30-35-208418,2705803,48,
2710850,2710895,2022-12-30_16-30-40-431020,2710897,45,
2715979,2716011,2022-12-30_16-30-45-660082,2716017,32,
2721118,2721218,2022-12-30_16-30-50-999823,2721221,100,
2726236,2726302,2022-12-30_16-30-56-203538,2726307,66,
2731345,2731394,2022-12-30_16-31-01-419050,2731398,49,
2736452,2736502,2022-12-30_16-31-06-646316,2736504,50,
2741552,2741571,2022-12-30_16-31-11-838098,2741574,19,
2746675,2746696,2022-12-30_16-31-17-089815,2746699,21,
2751779,2751801,2022-12-30_16-31-22-313394,2751803,22,
2756918,2757001,2022-12-30_16-31-27-637950,2757006,83,
2762042,2762114,2022-12-30_16-31-32-862552,2762119,72,
2767149,2767192,2022-12-30_16-31-38-075055,2767195,43,
2772257,2772321,2022-12-30_16-31-43-313527,2772326,64,
2777357,2777376,2022-12-30_16-31-48-505109,2777379,19,
2782497,2782517,2022-12-30_16-31-53-761579,2782520,20,
2787601,2787620,2022-12-30_16-31-58-992497,2787623,19,
2792722,2792788,2022-12-30_16-32-04-283977,2792791,66,
2797834,2797855,2022-12-30_16-32-09-466762,2797858,21,
2802951,2803002,2022-12-30_16-32-14-743414,2803005,51,
2808084,2808103,2022-12-30_16-32-19-975968,2808106,19,
2813187,2813207,2022-12-30_16-32-25-200152,2813210,20,
2818306,2818406,2022-12-30_16-32-30-514015,2818411,100,
2823409,2823491,2022-12-30_16-32-35-729450,2823494,82,
2828512,2828532,2022-12-30_16-32-40-886723,2828534,20,
2833632,2833690,2022-12-30_16-32-46-171989,2833693,58,
2838769,2838797,2022-12-30_16-32-51-396906,2838800,28,
2843875,2843901,2022-12-30_16-32-56-620722,2843905,26,
2848984,2854081,2022-12-30_16-33-01-949653,2854089,5097,
2854101,2854123,2022-12-30_16-33-07-092704,2854125,22,
2859238,2859312,2022-12-30_16-33-12-397258,2859317,74,
2864378,2864402,2022-12-30_16-33-17-617424,2864407,24,
2869498,2869519,2022-12-30_16-33-22-858703,2869522,21,
2874610,2874633,2022-12-30_16-33-28-090831,2874636,23,
2879717,2879808,2022-12-30_16-33-33-386924,2879813,91,
2884844,2884903,2022-12-30_16-33-38-611071,2884908,59,
2889982,2890008,2022-12-30_16-33-43-828532,2890010,26,
2895101,2895127,2022-12-30_16-33-49-071139,2895129,26,
2900227,2900307,2022-12-30_16-33-54-381790,2900312,80,
2905344,2905407,2022-12-30_16-33-59-594699,2905410,63,
2910484,2910512,2022-12-30_16-34-04-817945,2910515,28,
2915590,2915624,2022-12-30_16-34-10-050100,2915627,34,
2920714,2920735,2022-12-30_16-34-15-283992,2920738,21,
2925823,2925911,2022-12-30_16-34-20-585143,2925914,88,
2930937,2931012,2022-12-30_16-34-25-808232,2931015,75,
2936047,2936113,2022-12-30_16-34-31-031523,2936116,66,
2941187,2941212,2022-12-30_16-34-36-254741,2941214,25,
2946307,2946329,2022-12-30_16-34-41-485957,2946331,22,
2951415,2951435,2022-12-30_16-34-46-712942,2951438,20,
2956562,2956582,2022-12-30_16-34-51-982446,2956585,20,
2961679,2961732,2022-12-30_16-34-57-253586,2961735,53,
2966787,2966842,2022-12-30_16-35-02-477901,2966845,55,
2971894,2971941,2022-12-30_16-35-07-699465,2971946,47,
2977002,2977034,2022-12-30_16-35-12-915405,2977037,32,
2982147,2982167,2022-12-30_16-35-18-170320,2982171,20,
2987254,2987278,2022-12-30_16-35-23-402020,2987280,24,
2992403,2992443,2022-12-30_16-35-28-683173,2992446,40,
2997502,2997522,2022-12-30_16-35-33-891795,2997525,20,
3002649,3002667,2022-12-30_16-35-39-158380,3002671,18,
3007763,3007839,2022-12-30_16-35-44-451785,3007842,76,
3012890,3012943,2022-12-30_16-35-49-675803,3012947,53,
3017997,3018053,2022-12-30_16-35-54-906524,3018056,56,
3023104,3023151,2022-12-30_16-36-00-127335,3023156,47,
3028204,3028228,2022-12-30_16-36-05-324877,3028231,24,
3033318,3033336,2022-12-30_16-36-10-550654,3033339,18,
3038454,3038475,2022-12-30_16-36-15-811058,3038478,21,
3043602,3043621,2022-12-30_16-36-21-080632,3043624,19,
3048712,3048734,2022-12-30_16-36-26-314678,3048737,22,
3053855,3053874,2022-12-30_16-36-31-579403,3053877,19,
3058989,3059070,2022-12-30_16-36-36-895176,3059076,81,
3064097,3064164,2022-12-30_16-36-42-109054,3064167,67,
3069213,3069286,2022-12-30_16-36-47-340865,3069291,73,
3074322,3074362,2022-12-30_16-36-52-551924,3074365,40,
3079420,3079440,2022-12-30_16-36-57-750172,3079443,20,
3084562,3084583,2022-12-30_16-37-03-015728,3084586,21,
3089673,3089755,2022-12-30_16-37-08-319737,3089764,82,
3094780,3094801,2022-12-30_16-37-13-475015,3094804,21,
3099892,3099911,2022-12-30_16-37-18-708530,3099914,19,
3105047,3105071,2022-12-30_16-37-23-989309,3105074,24,
3110147,3110169,2022-12-30_16-37-29-212905,3110172,22,
3115317,3115372,2022-12-30_16-37-34-537081,3115375,55,
3120425,3120464,2022-12-30_16-37-39-758539,3120467,39,
3125532,3125579,2022-12-30_16-37-44-987876,3125584,47,
3130631,3130675,2022-12-30_16-37-50-209039,3130679,44,
3135764,3135794,2022-12-30_16-37-55-443078,3135799,30,
3140900,3140920,2022-12-30_16-38-00-692246,3140924,20,
3146018,3146083,2022-12-30_16-38-05-978988,3146086,65,
3151117,3151136,2022-12-30_16-38-11-156479,3151139,19,
3156234,3156285,2022-12-30_16-38-16-424426,3156288,51,
3161345,3161389,2022-12-30_16-38-21-652233,3161392,44,
3166453,3166484,2022-12-30_16-38-26-864201,3166487,31,
3171571,3171591,2022-12-30_16-38-32-101114,3171594,20,
3176702,3176721,2022-12-30_16-38-37-361561,3176725,19,
3181813,3181832,2022-12-30_16-38-42-590384,3181835,19,
3186936,3186992,2022-12-30_16-38-47-863939,3186997,56,
3192045,3192084,2022-12-30_16-38-53-084132,3192089,39,
3197172,0,,3197273,-3197172,
3202283,3202376,2022-12-30_16-39-03-622898,3202379,93,
3207403,3207487,2022-12-30_16-39-08-856282,3207493,84,
3212528,3212586,2022-12-30_16-39-14-078544,3212592,58,
3217659,3217680,2022-12-30_16-39-19-294685,3217683,21,
3222783,3222804,2022-12-30_16-39-24-542270,3222807,21,
3227890,3227911,2022-12-30_16-39-29-770527,3227914,21,
3233010,3233029,2022-12-30_16-39-35-009892,3233033,19,
3238127,3238179,2022-12-30_16-39-40-290900,3238185,52,
3243235,3243273,2022-12-30_16-39-45-508229,3243276,38,
3248372,3248392,2022-12-30_16-39-50-742115,3248396,20,
3253527,3253586,2022-12-30_16-39-56-062228,3253589,59,
3258659,3258681,2022-12-30_16-40-01-279205,3258684,22,
3263774,3263893,2022-12-30_16-40-06-607588,3268897,119,
3268910,3268991,2022-12-30_16-40-11-830525,3268994,81,
3274018,3274085,2022-12-30_16-40-17-045947,3274088,67,
3279117,3279198,2022-12-30_16-40-22-274733,3279204,81,
3284252,3284289,2022-12-30_16-40-27-491895,3284292,37,
3289373,3289392,2022-12-30_16-40-32-712856,3289397,19,
3294507,3294526,2022-12-30_16-40-37-967586,3294529,19,
3299615,3299644,2022-12-30_16-40-43-210782,3299647,29,
3304732,3304789,2022-12-30_16-40-48-481374,3304792,57,
3309840,3309861,2022-12-30_16-40-53-663745,3309864,21,
3314958,3315016,2022-12-30_16-40-58-939459,3315022,58,
3320095,3320116,2022-12-30_16-41-04-163467,3320120,21,
3325224,3325246,2022-12-30_16-41-09-410236,3325249,22,
3330331,3330418,2022-12-30_16-41-14-705059,3330422,87,
3335458,3335526,2022-12-30_16-41-19-929830,3335532,68,
3340555,3340575,2022-12-30_16-41-25-102813,3340579,20,
3345702,3345723,2022-12-30_16-41-30-371787,3345727,21,
3350823,3350919,2022-12-30_16-41-35-689290,3350922,96,
3355941,3356004,2022-12-30_16-41-40-898226,3356007,63,
3361073,3361117,2022-12-30_16-41-46-135449,3361120,44,
3366181,3366241,2022-12-30_16-41-51-369956,3366247,60,
3371309,3371336,2022-12-30_16-41-56-590376,3371339,27,
3376464,3376533,2022-12-30_16-42-01-912878,3376539,69,
3381571,3381635,2022-12-30_16-42-07-135600,3381638,64,
3386673,3386732,2022-12-30_16-42-12-357713,3386735,59,
3391788,3391840,2022-12-30_16-42-17-581884,3391846,52,
3396887,3396945,2022-12-30_16-42-22-804802,3396948,58,
3401996,3402017,2022-12-30_16-42-28-000140,3402020,21,
3407104,3407123,2022-12-30_16-42-33-230107,3407126,19,
3412220,3412242,2022-12-30_16-42-38-468628,3412245,22,
3417389,3417438,2022-12-30_16-42-43-797014,3417443,49,
3422488,3422510,2022-12-30_16-42-48-987082,3422513,22,
3427630,3427650,2022-12-30_16-42-54-257402,3427654,20,
3432737,3432757,2022-12-30_16-42-59-483719,3432759,20,
3437855,3437874,2022-12-30_16-43-04-722406,3437877,19,
3442963,3442985,2022-12-30_16-43-09-954116,3442988,22,
3448105,3448135,2022-12-30_16-43-15-230970,3448138,30,
3453247,3453268,2022-12-30_16-43-20-486557,3453271,21,
3458355,3458437,2022-12-30_16-43-25-775072,3458440,82,
3463473,3463538,2022-12-30_16-43-31-003664,3463547,65,
3468580,3468645,2022-12-30_16-43-36-226579,3468650,65,
3473723,3473749,2022-12-30_16-43-41-456119,3473753,26,
3478832,3478923,2022-12-30_16-43-46-763392,3478926,91,
3483952,3484036,2022-12-30_16-43-51-994996,3484040,84,
3489058,3489077,2022-12-30_16-43-57-158747,3489080,19,
3494175,3494217,2022-12-30_16-44-02-431961,3494221,42,
3499283,3499344,2022-12-30_16-44-07-666301,3499349,61,
3504402,3504438,2022-12-30_16-44-12-885307,3504443,36,
3509500,3509558,2022-12-30_16-44-18-128119,3509560,58,
3514618,3514638,2022-12-30_16-44-23-333027,3514641,20,
3519747,3519767,2022-12-30_16-44-28-582894,3519770,20,
3524865,3524933,2022-12-30_16-44-33-876154,3524936,68,
3529965,3529986,2022-12-30_16-44-39-044724,3529989,21,
3535113,3535134,2022-12-30_16-44-44-319864,3535138,21,
3540214,3540237,2022-12-30_16-44-49-553942,3540239,23,
3545330,3545424,2022-12-30_16-44-54-859377,3545426,94,
3550482,3550532,2022-12-30_16-45-00-084705,3550535,50,
3555617,3555637,2022-12-30_16-45-05-317667,3555640,20,
3560725,3565826,2022-12-30_16-45-10-740863,3565830,5101,
3565830,3565850,2022-12-30_16-45-15-773493,3565854,20,
3570939,3570962,2022-12-30_16-45-21-012887,3570965,23,
3576087,3576136,2022-12-30_16-45-26-308437,3576139,49,
3581213,3581233,2022-12-30_16-45-31-531504,3581236,20,
3586322,3586350,2022-12-30_16-45-36-761702,3586355,28,
3591437,3591456,2022-12-30_16-45-41-997034,3591460,19,
3596558,3596625,2022-12-30_16-45-47-291305,3596628,67,
3601685,3601716,2022-12-30_16-45-52-514200,3601719,31,
3606793,3606826,2022-12-30_16-45-57-742293,3606830,33,
3611926,3611946,2022-12-30_16-46-02-985019,3611949,20,
3617047,3617144,2022-12-30_16-46-08-294802,3617150,97,
3622163,3622183,2022-12-30_16-46-13-465877,3622186,20,
3627287,3627321,2022-12-30_16-46-18-727979,3627324,34,
3632394,3632425,2022-12-30_16-46-23-956266,3632430,31,
3637515,3637535,2022-12-30_16-46-29-190027,3637538,20,
3642618,3642638,2022-12-30_16-46-34-415501,3642641,20,
3647741,3647760,2022-12-30_16-46-39-661936,3647762,19,
3652903,3652940,2022-12-30_16-46-44-948860,3652946,37,
3658009,3658032,2022-12-30_16-46-50-172351,3658035,23,
3663135,3663156,2022-12-30_16-46-55-426670,3663159,21,
3668254,3668344,2022-12-30_16-47-00-725351,3668350,90,
3673364,3673383,2022-12-30_16-47-05-895247,3673386,19,
3678472,3678491,2022-12-30_16-47-11-127585,3678494,19,
3683675,3683739,2022-12-30_16-47-16-490266,3683744,64,
3688783,3688830,2022-12-30_16-47-21-711451,3688833,47,
3693920,3693941,2022-12-30_16-47-26-946610,3693943,21,
3699039,3699059,2022-12-30_16-47-32-182782,3699062,20,
3704166,3704185,2022-12-30_16-47-37-430842,3704188,19,
3709288,3709334,2022-12-30_16-47-42-705299,3709337,46,
3714387,3714406,2022-12-30_16-47-47-891589,3714409,19,
3719517,3719541,2022-12-30_16-47-53-148826,3719544,24,
3724648,3724668,2022-12-30_16-47-58-401470,3724671,20,
3729768,3729838,2022-12-30_16-48-03-697143,3729841,70,
3734897,3734941,2022-12-30_16-48-08-919372,3734945,44,
3740027,3740047,2022-12-30_16-48-14-150183,3740051,20,
3745143,3745164,2022-12-30_16-48-19-381333,3745168,21,
3750244,3750270,2022-12-30_16-48-24-606967,3750274,26,
3755352,3755372,2022-12-30_16-48-29-841740,3755375,20,
3760557,3760647,2022-12-30_16-48-35-235840,3760652,90,
3765656,3765676,2022-12-30_16-48-40-385682,3765679,20,
3770779,3770800,2022-12-30_16-48-45-636415,3770802,21,
3775914,3775951,2022-12-30_16-48-50-905681,3775954,37,
3781045,3781066,2022-12-30_16-48-56-144290,3781069,21,
3786184,3786248,2022-12-30_16-49-01-453416,3786254,64,
3791300,3791342,2022-12-30_16-49-06-666950,3791344,42,
3796406,3796443,2022-12-30_16-49-11-895199,3796446,37,
3801517,3801550,2022-12-30_16-49-17-117786,3801556,33,
3806623,3806648,2022-12-30_16-49-22-336589,3806650,25,
3811758,3811780,2022-12-30_16-49-27-589178,3811783,22,
3816866,3816949,2022-12-30_16-49-32-884080,3816954,83,
3822007,3822029,2022-12-30_16-49-38-081670,3822031,22,
3827125,3827144,2022-12-30_16-49-43-326590,3827147,19,
3832232,3832265,2022-12-30_16-49-48-559280,3832270,33,
3837331,3837351,2022-12-30_16-49-53-768743,3837353,20,
3842447,3842484,2022-12-30_16-49-59-030995,3842487,37,
3847550,3847570,2022-12-30_16-50-04-234847,3847573,20,
3852668,3852688,2022-12-30_16-50-09-477238,3852691,20,
3857827,3857861,2022-12-30_16-50-14-773352,3857864,34,
3862959,3862979,2022-12-30_16-50-20-016928,3862982,20,
3868067,3868097,2022-12-30_16-50-25-249187,3868100,30,
3873175,3873254,2022-12-30_16-50-30-536215,3873257,79,
3878291,3878311,2022-12-30_16-50-35-710863,3878314,20,
3883442,3883462,2022-12-30_16-50-40-986489,3883465,20,
3888549,3888665,2022-12-30_16-50-46-309798,3893683,116,
3893695,3893715,2022-12-30_16-50-51-480790,3893718,20,
3898796,3898872,2022-12-30_16-50-56-754135,3898875,76,
3903904,3903968,2022-12-30_16-51-01-978652,3903971,64,
3909009,3909043,2022-12-30_16-51-07-172325,3909045,34,
3914118,3914169,2022-12-30_16-51-12-418570,3914172,51,
3919234,3919271,2022-12-30_16-51-17-646899,3919273,37,
3924342,3924372,2022-12-30_16-51-22-868547,3924375,30,
3929452,3929479,2022-12-30_16-51-28-092734,3929482,27,
3934592,3934612,2022-12-30_16-51-33-347980,3934615,20,
3939709,3939786,2022-12-30_16-51-38-637658,3939791,77,
3944811,3944832,2022-12-30_16-51-43-806872,3944834,21,
3949939,3949976,2022-12-30_16-51-49-074241,3949979,37,
3955040,3955105,2022-12-30_16-51-54-311738,3955110,65,
3960155,3960185,2022-12-30_16-51-59-527448,3960188,30,
3965272,3965293,2022-12-30_16-52-04-758819,3965295,21,
3970386,3970406,2022-12-30_16-52-09-988162,3970409,20,
3975524,3975543,2022-12-30_16-52-15-248768,3975546,19,
3980641,3980691,2022-12-30_16-52-20-518006,3980694,50,
3985749,3985788,2022-12-30_16-52-25-741350,3985790,39,
3990883,3990901,2022-12-30_16-52-30-967952,3990903,18,
3995987,3996006,2022-12-30_16-52-36-195029,3996010,19,
4001112,4001131,2022-12-30_16-52-41-439906,4001134,19,
4006219,4006239,2022-12-30_16-52-46-668408,4006242,20,
4011350,4011413,2022-12-30_16-52-51-957738,4011416,63,
4016492,4016512,2022-12-30_16-52-57-181714,4016515,20,
4021618,4021638,2022-12-30_16-53-02-428468,4021642,20,
4026725,4026745,2022-12-30_16-53-07-655988,4026748,20,
4031872,4031908,2022-12-30_16-53-12-950182,4031911,36,
4037004,4037027,2022-12-30_16-53-18-184692,4037029,23,
4042130,4042210,2022-12-30_16-53-23-497587,4042214,80,
4047260,4047309,2022-12-30_16-53-28-719324,4047312,49,
4052392,4052415,2022-12-30_16-53-33-944641,4052418,23,
4057519,4057538,2022-12-30_16-53-39-192292,4057541,19,
4062627,4062647,2022-12-30_16-53-44-427048,4062649,20,
4067735,4067755,2022-12-30_16-53-49-654802,4067758,20,
4072852,4072908,2022-12-30_16-53-54-935241,4072911,56,
4077990,4078012,2022-12-30_16-54-00-159318,4078016,22,
4083133,4083212,2022-12-30_16-54-05-480960,4083216,79,
4088275,4088319,2022-12-30_16-54-10-704600,4088325,44,
4093374,4093394,2022-12-30_16-54-15-906763,4093396,20,
4098481,4098501,2022-12-30_16-54-21-136876,4098504,20,
4103595,4103616,2022-12-30_16-54-26-373141,4103619,21,
4108734,4108807,2022-12-30_16-54-31-697104,4108811,73,
4113856,4113912,2022-12-30_16-54-36-918250,4113916,56,
4118995,4119015,2022-12-30_16-54-42-140197,4119018,20,
4124122,4124144,2022-12-30_16-54-47-389425,4124147,22,
4129230,4129249,2022-12-30_16-54-52-618762,4129252,19,
4134363,4134424,2022-12-30_16-54-57-912725,4134428,61,
4139496,4139525,2022-12-30_16-55-03-133137,4139528,29,
4144636,4144657,2022-12-30_16-55-08-387673,4144660,21,
4149768,4149830,2022-12-30_16-55-13-681797,4149833,62,
4154910,4154931,2022-12-30_16-55-18-906314,4154934,21,
4160055,4160116,2022-12-30_16-55-24-218545,4160118,61,
4165153,4165173,2022-12-30_16-55-29-393063,4165177,20,
4170271,4170319,2022-12-30_16-55-34-667362,4170322,48,
4175403,4175423,2022-12-30_16-55-39-898471,4175426,20,
4180521,4180540,2022-12-30_16-55-45-134680,4180543,19,
4185643,4185745,2022-12-30_16-55-50-467951,4185748,102,
4190753,4190773,2022-12-30_16-55-55-608469,4190776,20,
4195888,4195907,2022-12-30_16-56-00-868509,4195910,19,
4201016,4201038,2022-12-30_16-56-06-116794,4201041,22,
4206122,4206142,2022-12-30_16-56-11-347284,4206145,20,
4211242,4211316,2022-12-30_16-56-16-641720,4211319,74,
4216366,4216433,2022-12-30_16-56-21-880821,4216436,67,
4221464,4221485,2022-12-30_16-56-27-052843,4221488,21,
4226618,4226639,2022-12-30_16-56-32-332142,4226642,21,
4231734,4231834,2022-12-30_16-56-37-648693,4231840,100,
4236858,4236889,2022-12-30_16-56-42-831134,4236892,31,
4241969,4241990,2022-12-30_16-56-48-046028,4241993,21,
4247085,4247140,2022-12-30_16-56-53-315645,4247144,55,
4252192,4252240,2022-12-30_16-56-58-539560,4252243,48,
4257306,4257343,2022-12-30_16-57-03-761195,4257346,37,
4262414,4262439,2022-12-30_16-57-08-979110,4262443,25,
4267522,4267552,2022-12-30_16-57-14-214128,4267554,30,
4272653,4272673,2022-12-30_16-57-19-458764,4272676,20,
4277761,4277781,2022-12-30_16-57-24-689099,4277784,20,
4282871,4282949,2022-12-30_16-57-29-978413,4282951,78,
4287984,4288052,2022-12-30_16-57-35-199583,4288057,68,
4293093,4293151,2022-12-30_16-57-40-422470,4293156,58,
4298193,4298216,2022-12-30_16-57-45-610932,4298219,23,
4303308,4303350,2022-12-30_16-57-50-869868,4303354,42,
4308421,4308453,2022-12-30_16-57-56-093738,4308460,32,
4313572,4313593,2022-12-30_16-58-01-357165,4313596,21,
4318689,4318752,2022-12-30_16-58-06-635988,4318755,63,
4323797,4323854,2022-12-30_16-58-11-859222,4323857,57,
4328895,4328915,2022-12-30_16-58-17-034296,4328918,20,
4334036,4334056,2022-12-30_16-58-22-307315,4334060,20,
4339153,4339174,2022-12-30_16-58-27-543530,4339177,21,
4344261,4344281,2022-12-30_16-58-32-766675,4344284,20,
4349396,4349461,2022-12-30_16-58-38-073766,4349463,65,
4354504,4354563,2022-12-30_16-58-43-297751,4354566,59,
4359612,4359660,2022-12-30_16-58-48-518041,4359664,48,
4364720,4364757,2022-12-30_16-58-53-739770,4364760,37,
4369828,4369859,2022-12-30_16-58-58-963594,4369862,31,
4374935,4374955,2022-12-30_16-59-04-187381,4374957,20,
4380075,4380096,2022-12-30_16-59-09-445554,4380099,21,
4385177,4385264,2022-12-30_16-59-14-733650,4385267,87,
4390288,4390366,2022-12-30_16-59-19-951135,4390370,78,
4395395,4395470,2022-12-30_16-59-25-173479,4395475,75,
4400510,4400582,2022-12-30_16-59-30-404863,4400588,72,
4405618,4405670,2022-12-30_16-59-35-623400,4405674,52,
4410727,4410747,2022-12-30_16-59-40-813304,4410751,20,
4415846,4415876,2022-12-30_16-59-46-072428,4415880,30,
4420979,4420999,2022-12-30_16-59-51-314697,4421002,20,
4426104,4426183,2022-12-30_16-59-56-620168,4426186,79,
4431239,
4436350,4436373,2022-12-30_17-00-07-059823,4436376,23,
4441469,4441497,2022-12-30_17-00-12-310132,4441499,28,
4446605,4446671,2022-12-30_17-00-17-608010,4446674,66,
4451702,4451722,2022-12-30_17-00-22-771665,4451724,20,
4456845,4456886,2022-12-30_17-00-28-060355,4456889,41,
4461983,4462004,2022-12-30_17-00-33-298834,4462008,21,
4467099,4467122,2022-12-30_17-00-38-542942,4467125,23,
4472219,4472282,2022-12-30_17-00-43-824237,4472291,63,
4477363,4477392,2022-12-30_17-00-49-046414,4477395,29,
4482489,4482510,2022-12-30_17-00-54-290962,4482513,21,
4487648,4487697,2022-12-30_17-00-59-594574,4487703,49,
4492777,4492804,2022-12-30_17-01-04-829588,4492808,27,
4497895,4497915,2022-12-30_17-01-10-065396,4497918,20,
4503021,4503041,2022-12-30_17-01-15-316954,4503044,20,
4508160,4508190,2022-12-30_17-01-20-584458,4508194,30,
4513287,4513312,2022-12-30_17-01-25-833461,4513316,25,
4518396,4518415,2022-12-30_17-01-31-058459,4518418,19,
4523503,4523523,2022-12-30_17-01-36-288175,4523526,20,
4528631,4528690,2022-12-30_17-01-41-577917,4528693,59,
4533771,4533791,2022-12-30_17-01-46-804429,4533794,20,
4538939,4538995,2022-12-30_17-01-52-125426,4539000,56,
4544042,4544064,2022-12-30_17-01-57-314116,4544067,22,
4549176,4549196,2022-12-30_17-02-02-570238,4549198,20,
4554316,4554399,2022-12-30_17-02-07-894007,4554405,83,
4559436,4559457,2022-12-30_17-02-13-076336,4559460,21,
4564568,4564587,2022-12-30_17-02-18-329940,4564590,19,
4569696,4569716,2022-12-30_17-02-23-583945,4569718,20,
4574823,4574905,2022-12-30_17-02-28-889041,4574910,82,
4579930,4580004,2022-12-30_17-02-34-108910,4580007,74,
4585071,4585101,2022-12-30_17-02-39-331538,4585104,30,
4590202,4590222,2022-12-30_17-02-44-569507,4590225,20,
4595310,4595329,2022-12-30_17-02-49-808673,4595332,19,
4600431,4600510,2022-12-30_17-02-55-101852,4600513,79,
4605540,4605560,2022-12-30_17-03-00-277882,4605562,20,
4610659,4610679,2022-12-30_17-03-05-521502,4610682,20,
4615776,4615803,2022-12-30_17-03-10-763209,4615806,27,
4620921,4621014,2022-12-30_17-03-16-094652,4621019,93,
4626054,4626099,2022-12-30_17-03-21-316438,4626105,45,
4631155,4631202,2022-12-30_17-03-26-537243,4631204,47,
4636288,4636308,2022-12-30_17-03-31-765566,4636312,20,
4641393,4641414,2022-12-30_17-03-36-998588,4641417,21,
4646536,4646613,2022-12-30_17-03-42-309216,4646618,77,
4651640,4651710,2022-12-30_17-03-47-529262,4651713,70,
4656752,4656818,2022-12-30_17-03-52-758092,4656822,66,
4661856,4661878,2022-12-30_17-03-57-942820,4661881,22,
4666973,4667012,2022-12-30_17-04-03-196797,4667015,39,
4672080,4672127,2022-12-30_17-04-08-424085,4672132,47,
4677188,4677223,2022-12-30_17-04-13-638164,4677226,35,
4682296,4682324,2022-12-30_17-04-18-870407,4682327,28,
4687400,4687424,2022-12-30_17-04-24-091284,4687426,24,
4692538,4692560,2022-12-30_17-04-29-350225,4692562,22,
4697649,4697719,2022-12-30_17-04-34-636115,4697722,70,
4702759,4702829,2022-12-30_17-04-39-858252,4702835,70,
4707879,4707920,2022-12-30_17-04-45-081316,4707924,41,
4712978,4712998,2022-12-30_17-04-50-270031,4713002,20,
4718124,4718143,2022-12-30_17-04-55-547448,4718146,19,
4723266,4723332,2022-12-30_17-05-00-858607,4723335,66,
4728398,4728425,2022-12-30_17-05-06-074602,4728428,27,
4733522,4733545,2022-12-30_17-05-11-315206,4733549,23,
4738655,4738676,2022-12-30_17-05-16-573112,4738680,21,
4743772,4743819,2022-12-30_17-05-21-833758,4743821,47,
4748879,4748925,2022-12-30_17-05-27-064611,4748928,46,
4753987,4754021,2022-12-30_17-05-32-286249,4754024,34,
4759105,4759124,2022-12-30_17-05-37-508837,4759127,19,
4764216,4764318,2022-12-30_17-05-42-832711,4764321,102,
4769365,4769430,2022-12-30_17-05-48-058953,4769435,65,
4774490,4774537,2022-12-30_17-05-53-282888,4774540,47,
4779598,4779633,2022-12-30_17-05-58-501999,4779638,35,
4784703,4784728,2022-12-30_17-06-03-722478,4784730,25,
4789804,4789831,2022-12-30_17-06-08-948844,4789834,27,