RD,TS_received,TS_sent,AK,RoundTrip,
62426,62499,2022-12-28_20-27-08-838523,62505,73,
67545,67565,2022-12-28_20-27-14-022590,67569,20,
72684,72704,2022-12-28_20-27-19-290685,72708,20,
77837,82955,2022-12-28_20-27-24-768485,82965,5118,
82977,88071,2022-12-28_20-27-29-988961,88081,5094,
88097,93182,2022-12-28_20-27-35-189861,93185,5085,
93186,93257,2022-12-28_20-27-40-332959,93260,71,
98322,103497,2022-12-28_20-27-45-657828,103505,5175,
103526,103597,2022-12-28_20-27-50-917738,103600,71,
108608,108629,2022-12-28_20-27-56-067741,108633,21,
113738,118879,2022-12-28_20-28-01-426287,118894,5141,
118908,124017,2022-12-28_20-28-06-752565,124019,5109,
124020,124068,2022-12-28_20-28-11-874866,124071,48,
129127,134236,2022-12-28_20-28-17-196500,134245,5109,
134257,134306,2022-12-28_20-28-22-361808,134309,49,
139357,144486,2022-12-28_20-28-27-712028,144489,5129,
144489,149620,2022-12-28_20-28-32-966284,149624,5131,
149624,149678,2022-12-28_20-28-38-092073,149681,54,
154730,154775,2022-12-28_20-28-43-310835,154778,45,
159851,164968,2022-12-28_20-28-48-633294,164973,5117,
164974,170098,2022-12-28_20-28-53-958188,170103,5124,
170104,170190,2022-12-28_20-28-59-081552,170194,86,
175219,175241,2022-12-28_20-29-04-245506,175245,22,
180367,180436,2022-12-28_20-29-09-564163,180439,69,
185464,185551,2022-12-28_20-29-14-792808,185555,87,
190572,190592,2022-12-28_20-29-19-958024,190595,20,
195724,195748,2022-12-28_20-29-25-231766,195751,24,
200876,200954,2022-12-28_20-29-30-567644,200957,78,
205978,205997,2022-12-28_20-29-35-730178,205999,19,
211089,211148,2022-12-28_20-29-41-008010,211151,59,
216197,216255,2022-12-28_20-29-46-230534,216260,58,
221299,221319,2022-12-28_20-29-51-424624,221322,20,
226435,226458,2022-12-28_20-29-56-684121,226461,23,
231541,231565,2022-12-28_20-30-01-916941,231567,24,
236656,236680,2022-12-28_20-30-07-155973,236683,24,
241778,241848,2022-12-28_20-30-12-448638,241854,70,
246900,246922,2022-12-28_20-30-17-644102,246925,22,
252038,252058,2022-12-28_20-30-22-902993,252061,20,
257167,257187,2022-12-28_20-30-28-151622,257190,20,
262291,262355,2022-12-28_20-30-33-440652,262358,64,
267397,267465,2022-12-28_20-30-38-659991,267470,68,
272601,272657,2022-12-28_20-30-43-987459,272660,56,
277701,277721,2022-12-28_20-30-49-160536,277724,20,
282817,282865,2022-12-28_20-30-54-429701,282868,48,
287957,287977,2022-12-28_20-30-59-666944,287980,20,
293080,293124,2022-12-28_20-31-04-943629,293126,44,
298186,298213,2022-12-28_20-31-10-145061,298216,27,
303308,303404,2022-12-28_20-31-15-457516,303408,96,
308424,308445,2022-12-28_20-31-20-616075,308448,21,
313550,313585,2022-12-28_20-31-25-876941,313588,35,
318682,318702,2022-12-28_20-31-31-115782,318706,20,
323799,323819,2022-12-28_20-31-36-356351,323822,20,
328934,328998,2022-12-28_20-31-41-646308,329001,64,
334066,334092,2022-12-28_20-31-46-868897,334094,26,
339187,339237,2022-12-28_20-31-52-139934,339239,50,
344307,344418,2022-12-28_20-31-57-438724,349448,111,
349465,349491,2022-12-28_20-32-02-634777,349493,26,
354580,354609,2022-12-28_20-32-07-865725,354614,29,
359694,359714,2022-12-28_20-32-13-107200,359717,20,
364824,364896,2022-12-28_20-32-18-410988,364899,72,
369958,369987,2022-12-28_20-32-23-616164,369990,29,
375086,375106,2022-12-28_20-32-28-857947,375110,20,
380217,380303,2022-12-28_20-32-34-174660,380308,86,
385326,385345,2022-12-28_20-32-39-349310,385347,19,
390433,390454,2022-12-28_20-32-44-574213,390457,21,
395554,395575,2022-12-28_20-32-49-811341,395578,21,
400674,400696,2022-12-28_20-32-55-053640,400699,22,
405819,405839,2022-12-28_20-33-00-322805,405843,20,
410940,411014,2022-12-28_20-33-05-611810,411017,74,
416077,416105,2022-12-28_20-33-10-832461,416108,28,
421200,421232,2022-12-28_20-33-16-067171,421236,32,
426332,426366,2022-12-28_20-33-21-322491,426368,34,
431447,431473,2022-12-28_20-33-26-561881,431476,26,
436555,436617,2022-12-28_20-33-31-821693,436621,62,
441711,441730,2022-12-28_20-33-37-064929,441733,19,
446823,446921,2022-12-28_20-33-42-373570,446926,98,
451944,452019,2022-12-28_20-33-47-599499,452022,75,
457043,457065,2022-12-28_20-33-52-759152,457068,22,
462186,462208,2022-12-28_20-33-58-020600,462210,22,
467303,467326,2022-12-28_20-34-03-261838,467331,23,
472453,472569,2022-12-28_20-34-08-616602,477549,116,
477567,477628,2022-12-28_20-34-13-806454,477631,61,
482665,482731,2022-12-28_20-34-19-028765,482733,66,
487767,487787,2022-12-28_20-34-24-207798,487790,20,
492884,492937,2022-12-28_20-34-29-474187,492940,53,
497991,498040,2022-12-28_20-34-34-702217,498046,49,
503101,503146,2022-12-28_20-34-39-923560,503151,45,
508209,508249,2022-12-28_20-34-45-148646,508255,40,
513329,513351,2022-12-28_20-34-50-377210,513354,22,
518437,518530,2022-12-28_20-34-55-683552,518533,93,
523551,523571,2022-12-28_20-35-00-841893,523575,20,
528666,528761,2022-12-28_20-35-06-133592,528768,95,
533788,533847,2022-12-28_20-35-11-350819,533851,59,
538896,538955,2022-12-28_20-35-16-578355,538958,59,
544005,544068,2022-12-28_20-35-21-810064,544074,63,
549111,549161,2022-12-28_20-35-27-026083,549164,50,
554218,559338,2022-12-28_20-35-32-247191,559349,5120,
559361,559452,2022-12-28_20-35-37-565232,559455,91,
564460,564544,2022-12-28_20-35-42-772186,564548,84,
569567,569665,2022-12-28_20-35-47-942808,569669,98,
574698,574771,2022-12-28_20-35-53-243872,574776,73,
579795,579816,2022-12-28_20-35-58-409404,579818,21,
584903,584924,2022-12-28_20-36-03-644256,584927,21,
590021,590061,2022-12-28_20-36-08-901688,590065,40,
595119,595139,2022-12-28_20-36-14-103020,595142,20,
600262,600284,2022-12-28_20-36-19-363082,600287,22,
605414,605434,2022-12-28_20-36-24-631371,605436,20,
610530,610591,2022-12-28_20-36-29-901404,610596,61,
615636,615656,2022-12-28_20-36-35-100231,615660,20,
620778,620863,2022-12-28_20-36-40-432809,620865,85,
625885,625906,2022-12-28_20-36-45-590226,625909,21,
631001,631079,2022-12-28_20-36-50-884818,631082,78,
636102,636123,2022-12-28_20-36-56-046731,636126,21,
641227,641336,2022-12-28_20-37-01-382130,646375,109,
646386,646407,2022-12-28_20-37-06-591344,646409,21,
651480,651504,2022-12-28_20-37-11-806789,651507,24,
656588,656608,2022-12-28_20-37-17-028179,656611,20,
661703,661731,2022-12-28_20-37-22-261341,661733,28,
666821,666868,2022-12-28_20-37-27-527846,666871,47,
671927,671947,2022-12-28_20-37-32-729445,671950,20,
677039,677062,2022-12-28_20-37-37-968486,677065,23,
682171,682199,2022-12-28_20-37-43-223118,682202,28,
687277,687307,2022-12-28_20-37-48-444804,687312,30,
692384,692406,2022-12-28_20-37-53-662282,692409,22,
697504,697524,2022-12-28_20-37-58-903732,697527,20,
702613,702633,2022-12-28_20-38-04-137907,702637,20,
707722,707743,2022-12-28_20-38-09-370022,707745,21,
712829,712849,2022-12-28_20-38-14-597745,712852,20,
717936,717957,2022-12-28_20-38-19-825743,717960,21,
723054,723114,2022-12-28_20-38-25-099192,723118,60,
728184,728216,2022-12-28_20-38-30-328422,728222,32,
733303,738413,2022-12-28_20-38-35-702292,738418,5110,
738418,738500,2022-12-28_20-38-40-862245,738509,82,
743557,743616,2022-12-28_20-38-46-098638,743622,59,
748686,748724,2022-12-28_20-38-51-321388,748729,38,
753816,753836,2022-12-28_20-38-56-557080,753839,20,
758923,758943,2022-12-28_20-39-01-784731,758946,20,
764030,764051,2022-12-28_20-39-07-015230,764054,21,
769139,769160,2022-12-28_20-39-12-242637,769163,21,
774272,779381,2022-12-28_20-39-17-536777,779397,5109,
779411,779432,2022-12-28_20-39-22-756751,779434,21,
784494,784542,2022-12-28_20-39-27-980151,784547,48,
789625,0,,794743,-789625,
794764,794826,2022-12-28_20-39-38-516214,794829,62,
799853,799922,2022-12-28_20-39-43-739381,799926,69,
805000,805034,2022-12-28_20-39-48-971496,805040,34,
810128,810160,2022-12-28_20-39-54-216494,810163,32,
815266,815352,2022-12-28_20-39-59-522375,815357,86,
820387,820436,2022-12-28_20-40-04-733852,820439,49,
825520,825542,2022-12-28_20-40-09-964902,825544,22,
830626,830650,2022-12-28_20-40-15-187828,830652,24,
835757,835777,2022-12-28_20-40-20-437428,835781,20,
840873,840959,2022-12-28_20-40-25-731961,840964,86,
845977,845998,2022-12-28_20-40-30-901745,846001,21,
851092,851158,2022-12-28_20-40-36-174236,851160,66,
856202,856257,2022-12-28_20-40-41-398622,856260,55,
861300,861323,2022-12-28_20-40-46-588149,861326,23,
866417,871537,2022-12-28_20-40-51-824409,871545,5120,
871560,871670,2022-12-28_20-40-57-170129,876670,110,
876682,876766,2022-12-28_20-41-02-389568,876771,84,
881787,881808,2022-12-28_20-41-07-554822,881812,21,
886948,886974,2022-12-28_20-41-12-841069,886979,26,
892105,892184,2022-12-28_20-41-18-167386,892189,79,
897211,897292,2022-12-28_20-41-23-391969,897297,81,
902319,902376,2022-12-28_20-41-28-599159,902379,57,
907418,907439,2022-12-28_20-41-33-789240,907441,21,
912569,912589,2022-12-28_20-41-39-061926,912592,20,
917741,917788,2022-12-28_20-41-44-379502,917793,47,
922842,922863,2022-12-28_20-41-49-569080,922866,21,
927985,928007,2022-12-28_20-41-54-832120,928010,22,
933092,933113,2022-12-28_20-42-00-062076,933116,21,
938200,938221,2022-12-28_20-42-05-297567,938224,21,
943317,943386,2022-12-28_20-42-10-583729,943390,69,
948405,948425,2022-12-28_20-42-15-737031,948427,20,
953532,953595,2022-12-28_20-42-21-028727,953598,63,
958641,958705,2022-12-28_20-42-26-256304,958707,64,
963760,963802,2022-12-28_20-42-31-474072,963805,42,
968865,968907,2022-12-28_20-42-36-701321,968913,42,
973975,974005,2022-12-28_20-42-41-925615,974011,30,
979111,979203,2022-12-28_20-42-47-243369,979206,92,
984219,984238,2022-12-28_20-42-52-395440,984241,19,
989333,989414,2022-12-28_20-42-57-688334,989417,81,
994435,994455,2022-12-28_20-43-02-851350,994458,20,
999552,999624,2022-12-28_20-43-08-133402,999628,72,
1004650,1004670,2022-12-28_20-43-13-299432,1004673,20,
1009800,1009834,2022-12-28_20-43-18-587019,1009837,34,
1014903,1014935,2022-12-28_20-43-23-805823,1014938,32,
1020028,1020049,2022-12-28_20-43-29-044839,1020051,21,
1025141,1025163,2022-12-28_20-43-34-280300,1025165,22,
1030259,1030341,2022-12-28_20-43-39-584626,1030343,82,
1035385,1035430,2022-12-28_20-43-44-797267,1035433,45,
1040494,1040541,2022-12-28_20-43-50-023562,1040547,47,
1045627,1045649,2022-12-28_20-43-55-252055,1045652,22,
1050772,1050802,2022-12-28_20-44-00-528326,1050805,30,
1055896,1055916,2022-12-28_20-44-05-772349,1055920,20,
1061032,1061053,2022-12-28_20-44-11-018820,1061056,21,
1066152,1066171,2022-12-28_20-44-16-259056,1066174,19,
1071279,1071359,2022-12-28_20-44-21-566847,1071364,80,
1076387,1076450,2022-12-28_20-44-26-786404,1076456,63,
1081522,1081554,2022-12-28_20-44-32-004256,1081557,32,
1086638,1086658,2022-12-28_20-44-37-230665,1086661,20,
1091766,1091793,2022-12-28_20-44-42-484019,1091796,27,
1096889,1096965,2022-12-28_20-44-47-780150,1096970,76,
1102022,1102080,2022-12-28_20-44-53-011962,1102084,58,
1107125,1112242,2022-12-28_20-44-58-330693,1112250,5117,
1112263,1112282,2022-12-28_20-45-03-464027,1112285,19,
1117380,1117400,2022-12-28_20-45-08-702924,1117402,20,
1122499,1122595,2022-12-28_20-45-14-000988,1122601,96,
1127601,1127622,2022-12-28_20-45-19-166097,1127626,21,
1132710,1132732,2022-12-28_20-45-24-392726,1132735,22,
1137859,1137885,2022-12-28_20-45-29-665254,1137891,26,
1142980,1143074,2022-12-28_20-45-34-977556,1143077,94,
1148093,1148113,2022-12-28_20-45-40-134255,1148116,20,
1153217,1153303,2022-12-28_20-45-45-436405,1153309,86,
1158342,1158361,2022-12-28_20-45-50-624202,1158364,19,
1163475,1163496,2022-12-28_20-45-55-878513,1163500,21,
1168602,1168622,2022-12-28_20-46-01-126059,1168625,20,
1173733,1173806,2022-12-28_20-46-06-426632,1173812,73,
1178869,1178898,2022-12-28_20-46-11-642692,1178904,29,
1183997,1184019,2022-12-28_20-46-16-892546,1184022,22,
1189107,1189127,2022-12-28_20-46-22-117176,1189130,20,
1194215,1194234,2022-12-28_20-46-27-348349,1194237,19,
1199323,1199344,2022-12-28_20-46-32-579162,1199346,21,
1204430,1209535,2022-12-28_20-46-37-807285,1209545,5105,
1209566,1209615,2022-12-28_20-46-43-079727,1209618,49,
1214655,1214715,2022-12-28_20-46-48-305442,1214718,60,
1219796,1219816,2022-12-28_20-46-53-537966,1219820,20,
1224914,1224935,2022-12-28_20-46-58-777553,1224938,21,
1230039,1230126,2022-12-28_20-47-04-080127,1230131,87,
1235161,1235223,2022-12-28_20-47-09-299845,1235226,62,
1240294,1240319,2022-12-28_20-47-14-524818,1240325,25,
1245441,1245463,2022-12-28_20-47-19-789094,1245465,22,
1250548,1250569,2022-12-28_20-47-25-015886,1250572,21,
1255692,1255728,2022-12-28_20-47-30-293008,1255733,36,
1260799,1265904,2022-12-28_20-47-35-524043,1265913,5105,
1265925,1265966,2022-12-28_20-47-40-781279,1265969,41,
1271010,1271030,2022-12-28_20-47-45-961256,1271033,20,
1276158,1276239,2022-12-28_20-47-51-287001,1276245,81,
1281262,1281286,2022-12-28_20-47-56-455167,1281290,24,
1286379,1286422,2022-12-28_20-48-01-720115,1286425,43,
1291503,1291536,2022-12-28_20-48-06-952759,1291539,33,
1296611,1296634,2022-12-28_20-48-12-167665,1296637,23,
1301744,1301765,2022-12-28_20-48-17-418948,1301767,21,
1306851,1306872,2022-12-28_20-48-22-648913,1306875,21,
1311976,1311997,2022-12-28_20-48-27-890385,1312000,21,
1317083,1317104,2022-12-28_20-48-33-124449,1317106,21,
1322227,1322251,2022-12-28_20-48-38-389486,1322254,24,
1327372,1327393,2022-12-28_20-48-43-658836,1327396,21,
1332489,1332556,2022-12-28_20-48-48-931938,1332559,67,
1337598,1337680,2022-12-28_20-48-54-171914,1337683,82,
1342696,1342716,2022-12-28_20-48-59-340392,1342718,20,
1347813,1347854,2022-12-28_20-49-04-599102,1347859,41,
1352922,1352948,2022-12-28_20-49-09-815453,1352951,26,
1358058,1358151,2022-12-28_20-49-15-141277,1358154,93,
1363195,1363266,2022-12-28_20-49-20-377078,1363269,71,
1368281,1368302,2022-12-28_20-49-25-528334,1368305,21,
1373409,1373458,2022-12-28_20-49-30-808719,1373461,49,
1378516,1378584,2022-12-28_20-49-36-036753,1378587,68,
1383625,1383673,2022-12-28_20-49-41-258960,1383676,48,
1388734,1388766,2022-12-28_20-49-46-481611,1388770,32,
1393854,1393904,2022-12-28_20-49-51-738524,1393907,50,
1398963,1404090,2022-12-28_20-49-57-141597,1404093,5127,
1404093,1404118,2022-12-28_20-50-02-200236,1404121,25,
1409200,1409221,2022-12-28_20-50-07-433623,1409224,21,
1414349,1414376,2022-12-28_20-50-12-695676,1414379,27,
1419449,1424558,2022-12-28_20-50-18-128600,1424561,5109,
1424561,1424593,2022-12-28_20-50-23-156525,1424596,32,
1429675,1429766,2022-12-28_20-50-28-460016,1429769,91,
1434782,0,,1434881,-1434782,
1439901,1439921,2022-12-28_20-50-38-843756,1439924,20,
1445011,1445101,2022-12-28_20-50-44-133518,1445106,90,
1450137,1450191,2022-12-28_20-50-49-354681,1450194,54,
1455245,1455286,2022-12-28_20-50-54-567305,1455289,41,
1460355,1460395,2022-12-28_20-50-59-795703,1460398,40,
1465461,1465500,2022-12-28_20-51-05-026232,1465506,39,
1470570,1470611,2022-12-28_20-51-10-245574,1470614,41,
1475699,1475721,2022-12-28_20-51-15-488390,1475724,22,
1480825,1480901,2022-12-28_20-51-20-796584,1480904,76,
1485954,1485997,2022-12-28_20-51-26-011435,1486000,43,
1491078,1491113,2022-12-28_20-51-31-242318,1491119,35,
1496209,1496230,2022-12-28_20-51-36-480152,1496233,21,
1501334,1501419,2022-12-28_20-51-41-790524,1501425,85,
1506435,1506522,2022-12-28_20-51-47-008150,1506527,87,
1511550,1511616,2022-12-28_20-51-52-225728,1511619,66,
1516657,1516721,2022-12-28_20-51-57-453463,1516726,64,
1521789,1521812,2022-12-28_20-52-02-668016,1521815,23,
1526913,1526934,2022-12-28_20-52-07-909790,1526938,21,
1532038,1532058,2022-12-28_20-52-13-145867,1532061,20,
1537145,1537231,2022-12-28_20-52-18-445500,1537237,86,
1542268,1542292,2022-12-28_20-52-23-634455,1542295,24,
1547385,0,,1552514,-1547385,
1552527,1552547,2022-12-28_20-52-34-128605,1552550,20,
1557646,1557666,2022-12-28_20-52-39-372854,1557669,20,
1562773,1562900,2022-12-28_20-52-44-713475,1567874,127,
1567895,1567936,2022-12-28_20-52-49-879071,1567939,41,
1573024,1573044,2022-12-28_20-52-55-108637,1573047,20,
1578155,1578178,2022-12-28_20-53-00-361058,1578181,23,
1583273,1583295,2022-12-28_20-53-05-601292,1583298,22,
1588391,1588460,2022-12-28_20-53-10-884610,1588465,69,
1593520,1593560,2022-12-28_20-53-16-102406,1593563,40,
1598628,1598652,2022-12-28_20-53-21-318623,1598655,24,
1603759,1603781,2022-12-28_20-53-26-568528,1603784,22,
1608888,1608908,2022-12-28_20-53-31-817088,1608911,20,
1613997,1614018,2022-12-28_20-53-37-046282,1614021,21,
1619114,1619134,2022-12-28_20-53-42-285899,1619137,20,
1624233,1624253,2022-12-28_20-53-47-521504,1624256,20,
1629368,1629388,2022-12-28_20-53-52-780586,1629391,20,
1634503,0,,1634573,-1634503,
1639607,1639667,2022-12-28_20-54-03-304982,1639670,60,
1644737,1644781,2022-12-28_20-54-08-530828,1644787,44,
1649875,0,,1649896,-1649875,
1655000,1655020,2022-12-28_20-54-19-018400,1655023,20,
1660123,1660190,2022-12-28_20-54-24-303487,1660195,67,
1665255,1665288,2022-12-28_20-54-29-522300,1665291,33,
1670382,1670415,2022-12-28_20-54-34-751114,1670420,33,
1675508,1675534,2022-12-28_20-54-40-009649,1675538,26,
1680625,1680688,2022-12-28_20-54-45-283613,1680691,63,
1685725,1690846,2022-12-28_20-54-50-458572,1690862,5121,
1690880,1690901,2022-12-28_20-54-55-730252,1690904,21,
1695961,1696006,2022-12-28_20-55-00-962867,1696011,45,
1701068,1701109,2022-12-28_20-55-06-185030,1701112,41,
1706172,1706200,2022-12-28_20-55-11-401758,1706203,28,
1711333,1711403,2022-12-28_20-55-16-721306,1711407,70,
1716432,1716500,2022-12-28_20-55-21-949360,1716504,68,
1721548,1721608,2022-12-28_20-55-27-172041,1721613,60,
1726656,1726711,2022-12-28_20-55-32-397540,1726715,55,
1731764,1731824,2022-12-28_20-55-37-622205,1731830,60,
1736872,1736908,2022-12-28_20-55-42-839594,1736911,36,
1741980,1742016,2022-12-28_20-55-48-061668,1742018,36,
1747087,1747111,2022-12-28_20-55-53-276265,1747114,24,
1752221,1752315,2022-12-28_20-55-58-603068,1752318,94,
1757335,1757357,2022-12-28_20-56-03-766664,1757360,22,
1762447,1762533,2022-12-28_20-56-09-054458,1762538,86,
1767559,1767640,2022-12-28_20-56-14-282216,1767645,81,
1772657,1772727,2022-12-28_20-56-19-498896,1772730,70,
1777775,1777818,2022-12-28_20-56-24-714885,1777821,43,
1782880,1782926,2022-12-28_20-56-29-944897,1782928,46,
1787989,1788019,2022-12-28_20-56-35-160034,1788023,30,
1793090,1793140,2022-12-28_20-56-40-389006,1793143,50,
1798207,1798237,2022-12-28_20-56-45-610296,1798240,30,
1803359,1803444,2022-12-28_20-56-50-941310,1803450,85,
1808469,1808564,2022-12-28_20-56-56-183700,1808568,95,
1813572,1813592,2022-12-28_20-57-01-332022,1813595,20,
1818678,1818699,2022-12-28_20-57-06-559076,1818703,21,
1823829,1823857,2022-12-28_20-57-11-831200,1823859,28,
1828934,1834067,2022-12-28_20-57-17-153886,1834077,5133,
1834089,1834109,2022-12-28_20-57-22-332067,1834114,20,
1839180,1839251,2022-12-28_20-57-27-596392,1839254,71,
1844295,1844348,2022-12-28_20-57-32-814663,1844351,53,
1849403,1849452,2022-12-28_20-57-38-041284,1849455,49,
1854547,1854573,2022-12-28_20-57-43-281941,1854575,26,
1859691,1859726,2022-12-28_20-57-48-546083,1859729,35,
1864822,1864864,2022-12-28_20-57-53-813843,1864867,42,
1869929,1869962,2022-12-28_20-57-59-038528,1869967,33,
1875038,1875063,2022-12-28_20-58-04-260115,1875065,25,
1880185,1880209,2022-12-28_20-58-09-527527,1880211,24,
1885295,1885363,2022-12-28_20-58-14-803569,1885366,68,
1890411,1890467,2022-12-28_20-58-20-028625,1890470,56,
1895552,1895573,2022-12-28_20-58-25-254232,1895576,21,
1900694,1900762,2022-12-28_20-58-30-569638,1900765,68,
1905803,1905822,2022-12-28_20-58-35-744770,1905825,19,
1910930,1910951,2022-12-28_20-58-40-993621,1910954,21,
1916067,1916087,2022-12-28_20-58-46-252206,1916090,20,
1921173,1921193,2022-12-28_20-58-51-486688,1921197,20,
1926287,1926309,2022-12-28_20-58-56-718333,1926312,22,
1931415,1931482,2022-12-28_20-59-02-015759,1931485,67,
1936541,1936584,2022-12-28_20-59-07-242076,1936587,43,
1941648,1941676,2022-12-28_20-59-12-456247,1941679,28,
1946784,1946805,2022-12-28_20-59-17-699014,1946807,21,
1951892,1951912,2022-12-28_20-59-22-931456,1951915,20,
1957008,1957099,2022-12-28_20-59-28-232856,1957104,91,
1962119,1962140,2022-12-28_20-59-33-397220,1962142,21,
1967262,1967298,2022-12-28_20-59-38-674619,1967301,36,
1972383,1972403,2022-12-28_20-59-43-902956,1972407,20,
1977503,1977594,2022-12-28_20-59-49-212137,1977597,91,
1982617,1982639,2022-12-28_20-59-54-367535,1982641,22,
1987739,1987813,2022-12-28_20-59-59-666461,1987816,74,
1992846,1992913,2022-12-28_21-00-04-885652,1992918,67,
1997948,1998004,2022-12-28_21-00-10-067622,1998006,56,
2003097,2003118,2022-12-28_21-00-15-334123,2003121,21,
2008197,2008216,2022-12-28_21-00-20-562253,2008220,19,
2013313,2013335,2022-12-28_21-00-25-802728,2013339,22,
2018444,2018514,2022-12-28_21-00-31-101145,2018516,70,
2023582,2023617,2022-12-28_21-00-36-325612,2023619,35,
2028686,2033816,2022-12-28_21-00-41-545221,2033825,5130,
2033837,2033857,2022-12-28_21-00-46-806307,2033860,20,
2038959,2039028,2022-12-28_21-00-52-096164,2039031,69,
2044094,2044117,2022-12-28_21-00-57-310585,2044120,23,
2049234,2049255,2022-12-28_21-01-02-559214,2049258,21,
2054356,2054376,2022-12-28_21-01-07-806894,2054379,20,
2059486,2059506,2022-12-28_21-01-13-057718,2059510,20,
2064602,2064639,2022-12-28_21-01-18-310101,2064642,37,
2069725,2069745,2022-12-28_21-01-23-538807,2069748,20,
2074869,2074889,2022-12-28_21-01-28-806226,2074892,20,
2080006,2080042,2022-12-28_21-01-34-081881,2080045,36,
2085147,2085167,2022-12-28_21-01-39-330324,2085170,20,
2090260,2090280,2022-12-28_21-01-44-561862,2090283,20,
2095399,2095419,2022-12-28_21-01-49-821399,2095423,20,
2100540,2100561,2022-12-28_21-01-55-088568,2100563,21,
2105656,2105744,2022-12-28_21-02-00-395062,2105746,88,
2110868,2110963,2022-12-28_21-02-05-722106,2110967,95,
2115964,2115985,2022-12-28_21-02-10-870801,2115988,21,
2121103,2121124,2022-12-28_21-02-16-133881,2121127,21,
2126260,2126281,2022-12-28_21-02-21-408497,2126284,21,
2131359,2131380,2022-12-28_21-02-26-621713,2131383,21,
2136513,2136535,2022-12-28_21-02-31-906836,2136537,22,
2141661,2141682,2022-12-28_21-02-37-177389,2141684,21,
2146814,2146835,2022-12-28_21-02-42-449959,2146837,21,
2151929,2151965,2022-12-28_21-02-47-704101,2151968,36,
2157036,2157076,2022-12-28_21-02-52-930193,2157082,40,
2162146,2162182,2022-12-28_21-02-58-149627,2162187,36,
2167251,2167284,2022-12-28_21-03-03-377730,2167289,33,
2172356,2172377,2022-12-28_21-03-08-608724,2172380,21,
2177484,2177504,2022-12-28_21-03-13-848865,2177507,20,
2182592,2182689,2022-12-28_21-03-19-141683,2182694,97,
2187716,2187790,2022-12-28_21-03-24-368588,2187795,74,
2192824,2192889,2022-12-28_21-03-29-590802,2192892,65,
2197933,2197989,2022-12-28_21-03-34-809044,2197994,56,
2203074,2203096,2022-12-28_21-03-40-033906,2203100,22,
2208180,2208206,2022-12-28_21-03-45-266834,2208209,26,
2213340,2213385,2022-12-28_21-03-50-574824,2213388,45,
2218440,2218459,2022-12-28_21-03-55-764831,2218462,19,
2223587,2223607,2022-12-28_21-04-01-036508,2223610,20,
2228693,2228720,2022-12-28_21-04-06-266226,2228723,27,
2233820,2233847,2022-12-28_21-04-11-512751,2233850,27,
2238936,2239001,2022-12-28_21-04-16-793950,2239004,65,
2244045,2249163,2022-12-28_21-04-22-131305,2249168,5118,
2249169,2249216,2022-12-28_21-04-27-243956,2249220,47,
2254276,2254299,2022-12-28_21-04-32-456304,2254302,23,
2259417,2259440,2022-12-28_21-04-37-716447,2259443,23,
2264524,2264621,2022-12-28_21-04-43-008636,2264627,97,
2269650,2269727,2022-12-28_21-04-48-237449,2269732,77,
2274750,2274770,2022-12-28_21-04-53-405928,2274773,20,
2279898,2279918,2022-12-28_21-04-58-679035,2279920,20,
2285015,2285037,2022-12-28_21-05-03-913905,2285040,22,
2290169,2290220,2022-12-28_21-05-09-218976,2290223,51,
2295277,2295327,2022-12-28_21-05-14-450920,2295332,50,
2300382,2300423,2022-12-28_21-05-19-668220,2300425,41,
2305484,2305506,2022-12-28_21-05-24-869607,2305508,22,
2310630,2310651,2022-12-28_21-05-30-142276,2310654,21,
2315737,2315760,2022-12-28_21-05-35-366488,2315762,23,
2320872,2320933,2022-12-28_21-05-40-663969,2320937,61,
2326010,2326036,2022-12-28_21-05-45-886557,2326038,26,
2331142,2331162,2022-12-28_21-05-51-134417,2331165,20,
2336268,2336345,2022-12-28_21-05-56-438997,2336349,77,
2341390,2341451,2022-12-28_21-06-01-663045,2341456,61,
2346501,2346542,2022-12-28_21-06-06-876276,2346548,41,
2351641,2351661,2022-12-28_21-06-12-118155,2351664,20,
2356762,2356834,2022-12-28_21-06-17-416535,2356837,72,
2361906,2361945,2022-12-28_21-06-22-649588,2361948,39,
2367047,2367069,2022-12-28_21-06-27-892057,2367072,22,
2372172,2372246,2022-12-28_21-06-33-196362,2372249,74,
2377301,2377349,2022-12-28_21-06-38-418930,2377354,48,
2382430,2382451,2022-12-28_21-06-43-647725,2382454,21,
2387556,2387585,2022-12-28_21-06-48-895438,2387589,29,
2392679,2392763,2022-12-28_21-06-54-195091,2392768,84,
2397815,2397856,2022-12-28_21-06-59-410928,2397862,41,
2402921,2402955,2022-12-28_21-07-04-630188,2402959,34,
2408057,2408078,2022-12-28_21-07-09-871915,2408081,21,
2413212,2413276,2022-12-28_21-07-15-182941,2413281,64,
2418310,2418372,2022-12-28_21-07-20-400150,2418375,62,
2423461,2423482,2022-12-28_21-07-25-637969,2423485,21,
2428563,2428584,2022-12-28_21-07-30-853859,2428587,21,
2433685,2433706,2022-12-28_21-07-36-096082,2433710,21,
2438806,2438877,2022-12-28_21-07-41-395295,2438880,71,
2443944,2443975,2022-12-28_21-07-46-614636,2443978,31,
2449051,2449075,2022-12-28_21-07-51-840246,2449077,24,
2454174,2454194,2022-12-28_21-07-57-075558,2454198,20,
2459288,2459311,2022-12-28_21-08-02-317433,2459314,23,
2464406,2464478,2022-12-28_21-08-07-610292,2464480,72,
2469514,2469535,2022-12-28_21-08-12-780246,2469538,21,
2474634,2474689,2022-12-28_21-08-18-055894,2474694,55,
2479764,2479796,2022-12-28_21-08-23-274225,2479799,32,
2484872,2484894,2022-12-28_21-08-28-503679,2484897,22,
2490009,2490029,2022-12-28_21-08-33-759795,2490032,20,
2495130,2495212,2022-12-28_21-08-39-056820,2495217,82,
2500273,2500299,2022-12-28_21-08-44-269050,2500302,26,
2505408,2505428,2022-12-28_21-08-49-517824,2505431,20,
2510515,2510535,2022-12-28_21-08-54-748800,2510538,20,
2515634,2520735,2022-12-28_21-09-00-137654,2520740,5101,
2520740,2520810,2022-12-28_21-09-05-259565,2520813,70,
2525851,2530984,2022-12-28_21-09-10-483090,2530994,5133,
2531006,2531026,2022-12-28_21-09-15-728888,2531031,20,
2536096,2536118,2022-12-28_21-09-20-935359,2536121,22,
2541230,2541250,2022-12-28_21-09-26-192884,2541253,20,
2546341,2546422,2022-12-28_21-09-31-474202,2546424,81,
2551455,0,,2551512,-2551455,
2556578,2556624,2022-12-28_21-09-41-924676,2556627,46,
2561671,2561729,2022-12-28_21-09-47-145201,2561732,58,
2566778,2566838,2022-12-28_21-09-52-364248,2566843,60,
2571887,2571935,2022-12-28_21-09-57-590726,2571938,48,
2576994,2577026,2022-12-28_21-10-02-813011,2577031,32,
2582102,2582130,2022-12-28_21-10-08-031693,2582133,28,
2587273,2587330,2022-12-28_21-10-13-360085,2587337,57,
2592380,2592429,2022-12-28_21-10-18-581624,2592433,49,
2597488,2597536,2022-12-28_21-10-23-807129,2597541,48,
2602627,2602648,2022-12-28_21-10-29-039936,2602651,21,
2607775,2607836,2022-12-28_21-10-34-353629,2607841,61,
2612884,2612934,2022-12-28_21-10-39-578812,2612937,50,
2617989,2618047,2022-12-28_21-10-44-801663,2618052,58,
2623099,2623142,2022-12-28_21-10-50-020966,2623145,43,
2628219,2628242,2022-12-28_21-10-55-241829,2628247,23,
2633327,2633444,2022-12-28_21-11-00-564182,2638450,117,
2638462,2638484,2022-12-28_21-11-05-714533,2638487,22,
2643562,2643584,2022-12-28_21-11-10-940954,2643588,22,
2648714,2648759,2022-12-28_21-11-16-238473,2648764,45,
2653822,2653857,2022-12-28_21-11-21-458205,2653861,35,
2658931,2658964,2022-12-28_21-11-26-676320,2658970,33,
2664038,2664094,2022-12-28_21-11-31-939265,2664097,56,
2669151,2669171,2022-12-28_21-11-37-139901,2669175,20,
2674287,2674358,2022-12-28_21-11-42-441525,2674361,71,
2679385,2679407,2022-12-28_21-11-47-616236,2679410,22,
2684544,2684564,2022-12-28_21-11-52-898798,2684567,20,
2689648,2689670,2022-12-28_21-11-58-124643,2689672,22,
2694776,2694798,2022-12-28_21-12-03-367350,2694801,22,
2699883,2704989,2022-12-28_21-12-08-768333,2704992,5106,
2704992,2705011,2022-12-28_21-12-13-828747,2705015,19,
2710107,2715221,2022-12-28_21-12-19-253611,2715236,5114,
2715257,2720329,2022-12-28_21-12-24-476422,2720344,5072,
2720361,2720484,2022-12-28_21-12-29-653700,2725438,123,
2725457,2725480,2022-12-28_21-12-34-776770,2725483,23,
2730530,2735653,2022-12-28_21-12-40-041253,2735669,5123,
2735681,2740761,2022-12-28_21-12-45-367494,2740764,5080,
2740764,2745900,2022-12-28_21-12-50-588285,2745908,5136,
2745921,2745941,2022-12-28_21-12-55-721182,2745944,20,
2751052,2756174,2022-12-28_21-13-01-034187,2756184,5122,
2756196,2756253,2022-12-28_21-13-06-274424,2756256,57,
2761318,2766441,2022-12-28_21-13-11-676856,2766447,5123,
2766447,2771584,2022-12-28_21-13-16-890906,2771586,5137,
2771592,2771614,2022-12-28_21-13-21-994146,2771617,22,
2776688,2781804,2022-12-28_21-13-27-351843,2781807,5116,
2781807,2786913,2022-12-28_21-13-32-779417,2786916,5106,
2786916,2787005,2022-12-28_21-13-37-734258,2787007,89,
2792040,2792121,2022-12-28_21-13-42-978410,2792126,81,
2797164,2802308,2022-12-28_21-13-48-344151,2802323,5144,
2802344,2802455,2022-12-28_21-13-53-565183,2807423,111,
2807444,2807509,2022-12-28_21-13-58-736927,2807512,65,
2812574,2812598,2022-12-28_21-14-03-959399,2812601,24,
2817680,2817716,2022-12-28_21-14-09-190621,2817719,36,
2822812,2822833,2022-12-28_21-14-14-430128,2822836,21,
2827941,2827961,2022-12-28_21-14-19-680027,2827964,20,
2833061,0,,2833121,-2833061,
2838169,2838216,2022-12-28_21-14-30-175813,2838220,47,
2843302,2843323,2022-12-28_21-14-35-405729,2843326,21,
2848417,2848437,2022-12-28_21-14-40-636511,2848440,20,
2853528,2853549,2022-12-28_21-14-45-873594,2853552,21,
2858636,2858658,2022-12-28_21-14-51-093754,2858660,22,
2863766,2863848,2022-12-28_21-14-56-401299,2863853,82,
2868901,2868927,2022-12-28_21-15-01-613606,2868930,26,
2874009,2874030,2022-12-28_21-15-06-836255,2874033,21,
2879130,2879152,2022-12-28_21-15-12-074148,2879154,22,
2884240,2884260,2022-12-28_21-15-17-307235,2884262,20,
2889371,2889399,2022-12-28_21-15-22-563361,2889402,28,
2894486,2894506,2022-12-28_21-15-27-795634,2894509,20,
2899609,2899647,2022-12-28_21-15-33-059387,2899652,38,
2904717,2904748,2022-12-28_21-15-38-281803,2904753,31,
2909826,2909851,2022-12-28_21-15-43-497443,2909853,25,
2914934,2914956,2022-12-28_21-15-48-724790,2914959,22,
2920037,2920058,2022-12-28_21-15-53-958365,2920061,21,
2925146,2925166,2022-12-28_21-15-59-183146,2925170,20,
2930270,2930289,2022-12-28_21-16-04-421403,2930292,19,
2935416,2935463,2022-12-28_21-16-09-717955,2935468,47,
2940528,2940567,2022-12-28_21-16-14-942456,2940572,39,
2945637,2945666,2022-12-28_21-16-20-159601,2945671,29,
2950746,2950773,2022-12-28_21-16-25-380628,2950776,27,
2955876,2955897,2022-12-28_21-16-30-634918,2955900,21,
2960993,2961069,2022-12-28_21-16-35-929446,2961074,76,
2966097,2966168,2022-12-28_21-16-41-152422,2966172,71,
2971205,2971273,2022-12-28_21-16-46-374297,2971276,68,
2976348,2976368,2022-12-28_21-16-51-601687,2976372,20,
2981500,2981565,2022-12-28_21-16-56-915414,2981568,65,
2986606,2986668,2022-12-28_21-17-02-139190,2986670,62,
2991714,2991780,2022-12-28_21-17-07-366792,2991785,66,
2996823,2996881,2022-12-28_21-17-12-589136,2996883,58,
3001937,3001981,2022-12-28_21-17-17-814372,3001986,44,
3007042,3007077,2022-12-28_21-17-23-029473,3007080,35,
3012182,3012202,2022-12-28_21-17-28-275390,3012205,20,
3017294,3017315,2022-12-28_21-17-33-509445,3017318,21,
3022401,3022422,2022-12-28_21-17-38-735603,3022426,21,
3027526,3027601,2022-12-28_21-17-44-029197,3027604,75,
3032633,3032699,2022-12-28_21-17-49-248729,3032703,66,
3037743,3037798,2022-12-28_21-17-54-471448,3037803,55,
3042841,3042862,2022-12-28_21-17-59-655987,3042865,21,
3047958,3048017,2022-12-28_21-18-04-919850,3048022,59,
3053064,3053104,2022-12-28_21-18-10-138955,3053107,40,
3058175,3058208,2022-12-28_21-18-15-362812,3058214,33,
3063274,3063294,2022-12-28_21-18-20-567940,3063296,20,
3068413,3068506,2022-12-28_21-18-25-903000,3068509,93,
3073520,3073615,2022-12-28_21-18-31-131204,3073618,95,
3078652,3078718,2022-12-28_21-18-36-354752,3078721,66,
3083759,3083817,2022-12-28_21-18-41-577160,3083823,58,
3088867,3088917,2022-12-28_21-18-46-798597,3088920,50,
3093977,3094031,2022-12-28_21-18-52-021358,3094034,54,
3099075,3099096,2022-12-28_21-18-57-209427,3099098,21,
3104182,3104231,2022-12-28_21-19-02-465817,3104233,49,
3109299,3109330,2022-12-28_21-19-07-688708,3109335,31,
3114409,3114447,2022-12-28_21-19-12-911183,3114452,38,
3119514,3119554,2022-12-28_21-19-18-145019,3119559,40,
3124617,3124636,2022-12-28_21-19-23-360084,3124639,19,
3129754,3129775,2022-12-28_21-19-28-621373,3129778,21,
3134863,3134941,2022-12-28_21-19-33-903758,3134944,78,
3139980,3140049,2022-12-28_21-19-39-126243,3140052,69,
3145078,3145099,2022-12-28_21-19-44-305212,3145102,21,
3150223,3150246,2022-12-28_21-19-49-573536,3150248,23,
3155339,3155359,2022-12-28_21-19-54-809828,3155363,20,
3160459,3160477,2022-12-28_21-20-00-052948,3160489,18,
3165587,3165668,2022-12-28_21-20-05-348596,3165674,81,
3170705,3170726,2022-12-28_21-20-10-531311,3170729,21,
3175828,3175849,2022-12-28_21-20-15-782442,3175851,21,
3180966,3180987,2022-12-28_21-20-21-037870,3180990,21,
3186075,3186095,2022-12-28_21-20-26-266967,3186098,20,
3191190,3191260,2022-12-28_21-20-31-549725,3191263,70,
3196324,3196363,2022-12-28_21-20-36-782000,3196367,39,
3201456,3201477,2022-12-28_21-20-42-019863,3201480,21,
3206570,3206592,2022-12-28_21-20-47-251697,3206595,22,
3211693,3211770,2022-12-28_21-20-52-551235,3211773,77,
3216841,3216863,2022-12-28_21-20-57-769226,3216866,22,
3221998,3222077,2022-12-28_21-21-03-100646,3222082,79,
3227106,3227126,2022-12-28_21-21-08-275262,3227129,20,
3232221,3232242,2022-12-28_21-21-13-508972,3232244,21,
3237346,3237385,2022-12-28_21-21-18-764373,3237388,39,
3242472,3242564,2022-12-28_21-21-24-082940,3242568,92,
3247583,3247606,2022-12-28_21-21-29-236732,3247609,23,
3252702,3252779,2022-12-28_21-21-34-526024,3252782,77,
3257825,3257893,2022-12-28_21-21-39-759502,3257895,68,
3262963,3262985,2022-12-28_21-21-44-981982,3262988,22,
3268090,3268112,2022-12-28_21-21-50-228207,3268114,22,
3273200,3273220,2022-12-28_21-21-55-455459,3273224,20,
3278324,3278400,2022-12-28_21-22-00-750691,3278403,76,
3283458,3283493,2022-12-28_21-22-05-973255,3283496,35,
3288591,3288611,2022-12-28_21-22-11-213993,3288614,20,
3293706,3293727,2022-12-28_21-22-16-443753,3293730,21,
3298831,3298902,2022-12-28_21-22-21-743317,3298907,71,
3303971,3304003,2022-12-28_21-22-26-965945,3304008,32,
3309100,3309121,2022-12-28_21-22-32-205009,3309124,21,
3314219,3314240,2022-12-28_21-22-37-436637,3314244,21,
3319328,3319349,2022-12-28_21-22-42-669402,3319352,21,
3324441,3324463,2022-12-28_21-22-47-900474,3324466,22,
3329554,3329625,2022-12-28_21-22-53-185036,3329628,71,
3334657,3334678,2022-12-28_21-22-58-356089,3334681,21,
3339774,3339826,2022-12-28_21-23-03-625832,3339831,52,
3344916,3344937,2022-12-28_21-23-08-851654,3344940,21,
3350035,3350055,2022-12-28_21-23-14-100332,3350058,20,
3355159,3355237,2022-12-28_21-23-19-403859,3355240,78,
3360274,3360293,2022-12-28_21-23-24-581020,3360296,19,
3365389,3365431,2022-12-28_21-23-29-832896,3365434,42,
3370488,3370541,2022-12-28_21-23-35-059422,3370544,53,
3375605,3375638,2022-12-28_21-23-40-287761,3375643,33,
3380704,3380736,2022-12-28_21-23-45-504224,3380738,32,
3385821,3385841,2022-12-28_21-23-50-729588,3385843,20,
3390930,3390955,2022-12-28_21-23-55-954878,3390958,25,
3396073,3396098,2022-12-28_21-24-01-232075,3396100,25,
3401188,3401250,2022-12-28_21-24-06-500170,3401253,62,
3406297,3406350,2022-12-28_21-24-11-719223,3406353,53,
3411404,3411469,2022-12-28_21-24-16-950689,3411474,65,
3416513,3416559,2022-12-28_21-24-22-168356,3416564,46,
3421622,3421670,2022-12-28_21-24-27-398616,3421673,48,
3426729,3426778,2022-12-28_21-24-32-616959,3426783,49,
3431837,3431857,2022-12-28_21-24-37-829435,3431860,20,
3436950,3436971,2022-12-28_21-24-43-064247,3436974,21,
3442058,3442078,2022-12-28_21-24-48-290930,3442081,20,
3447201,3447264,2022-12-28_21-24-53-605429,3447267,63,
3452307,3452365,2022-12-28_21-24-58-825004,3452370,58,
3457407,3457429,2022-12-28_21-25-04-006599,3457431,22,
3462554,3462575,2022-12-28_21-25-09-275695,3462578,21,
3467820,3467868,2022-12-28_21-25-14-691909,3467871,48,
3472931,3472980,2022-12-28_21-25-19-921825,3472983,49,
3478031,3478050,2022-12-28_21-25-25-111429,3478054,19,
3483164,3483184,2022-12-28_21-25-30-372041,3483187,20,
3488271,3488291,2022-12-28_21-25-35-596163,3488294,20,
3493401,3493421,2022-12-28_21-25-40-848488,3493424,20,
3498518,3498590,2022-12-28_21-25-46-128361,3498593,72,
3503626,3503676,2022-12-28_21-25-51-351122,3503679,50,
3508768,3508800,2022-12-28_21-25-56-600243,3508804,32,
3513895,3513915,2022-12-28_21-26-01-831826,3513918,20,
3519055,3519135,2022-12-28_21-26-07-173190,3519139,80,
3524162,3524204,2022-12-28_21-26-12-355553,3524208,42,
3529274,3529295,2022-12-28_21-26-17-584199,3529298,21,
3534398,3534420,2022-12-28_21-26-22-828498,3534422,22,
3539520,3539542,2022-12-28_21-26-28-065886,3539545,22,
3544664,3544684,2022-12-28_21-26-33-323235,3544687,20,
3549780,3549800,2022-12-28_21-26-38-566872,3549803,20,
3554910,3554930,2022-12-28_21-26-43-820270,3554933,20,
3560016,3560036,2022-12-28_21-26-49-046385,3560039,20,
3565156,3565203,2022-12-28_21-26-54-329770,3565206,47,
3570262,3570317,2022-12-28_21-26-59-561506,3570322,55,
3575370,3575412,2022-12-28_21-27-04-782745,3575417,42,
3580499,3580595,2022-12-28_21-27-10-097088,3580598,96,
3585613,3585633,2022-12-28_21-27-15-255251,3585636,20,
3590729,3590818,2022-12-28_21-27-20-552988,3590821,89,
3595853,3595937,2022-12-28_21-27-25-785708,3595942,84,
3600984,3601013,2022-12-28_21-27-31-002094,3601017,29,
3606119,3606140,2022-12-28_21-27-36-253840,3606143,21,
3611227,3611250,2022-12-28_21-27-41-479899,3611253,23,
3616344,3616410,2022-12-28_21-27-46-757751,3616412,66,
3621468,3621519,2022-12-28_21-27-51-988797,3621523,51,
3626600,3626630,2022-12-28_21-27-57-222705,3626635,30,
3631756,3631808,2022-12-28_21-28-02-526099,3631811,52,
3636906,3636931,2022-12-28_21-28-07-761799,3636937,25,
3642032,3642127,2022-12-28_21-28-13-074290,3642129,95,
3647147,3647220,2022-12-28_21-28-18-298501,3647223,73,
3652266,3652324,2022-12-28_21-28-23-528168,3652329,58,
3657409,3657430,2022-12-28_21-28-28-751496,3657433,21,
3662523,3662555,2022-12-28_21-28-33-984221,3662560,32,
3667638,3667659,2022-12-28_21-28-39-224552,3667662,21,
3672747,3672767,2022-12-28_21-28-44-458568,3672770,20,
3677868,3677946,2022-12-28_21-28-49-746056,3677951,78,
3682999,3683022,2022-12-28_21-28-54-952470,3683026,23,
3688130,3688150,2022-12-28_21-29-00-194848,3688153,20,
3693243,3693263,2022-12-28_21-29-05-431413,3693266,20,
3698360,3698438,2022-12-28_21-29-10-724617,3698441,78,
3703477,3703500,2022-12-28_21-29-15-909740,3703502,23,
3708584,3708615,2022-12-28_21-29-21-140877,3708619,31,
3713702,3713770,2022-12-28_21-29-26-399970,3713776,68,
3718841,3718865,2022-12-28_21-29-31-629642,3718868,24,
3723984,3724064,2022-12-28_21-29-36-952413,3724069,80,
3729110,3729162,2022-12-28_21-29-42-172510,3729166,52,
3734227,3734249,2022-12-28_21-29-47-371407,3734252,22,
3739354,3739375,2022-12-28_21-29-52-622376,3739378,21,
3744490,3744578,2022-12-28_21-29-57-943416,3744583,88,
3749592,3749615,2022-12-28_21-30-03-112095,3749618,23,
3754704,3754723,2022-12-28_21-30-08-331598,3754726,19,
3759812,3759832,2022-12-28_21-30-13-563275,3759836,20,
3764929,3764951,2022-12-28_21-30-18-797656,3764954,22,
3770041,3770060,2022-12-28_21-30-24-031940,3770063,19,
3775168,3775187,2022-12-28_21-30-29-283246,3775190,19,
3780286,3780311,2022-12-28_21-30-34-524833,3780313,25,
3785418,3785483,2022-12-28_21-30-39-818085,3785486,65,
3790526,3790588,2022-12-28_21-30-45-039190,3790591,62,
3795633,3795698,2022-12-28_21-30-50-267057,3795704,65,
3800734,3800754,2022-12-28_21-30-55-444930,3800757,20,
3805851,3805910,2022-12-28_21-31-00-718434,3805915,59,
3810950,3810970,2022-12-28_21-31-05-908115,3810973,20,
3816088,3816107,2022-12-28_21-31-11-172100,3816110,19,
3821195,3821306,2022-12-28_21-31-16-475509,3826327,111,
3826339,3826411,2022-12-28_21-31-21-704169,3826416,72,
3831450,3831509,2022-12-28_21-31-26-925553,3831513,59,
3836559,3841687,2022-12-28_21-31-32-271504,3841692,5128,
3841692,3841713,2022-12-28_21-31-37-376421,3841715,21,
3846799,3846820,2022-12-28_21-31-42-600955,3846824,21,
3851938,3851956,2022-12-28_21-31-47-862911,3851959,18,
3857037,3862149,2022-12-28_21-31-53-253587,3862163,5112,
3862185,3862218,2022-12-28_21-31-58-359986,3862220,33,
3867262,3867285,2022-12-28_21-32-03-551083,3867288,23,
3872414,3872435,2022-12-28_21-32-08-824814,3872438,21,
3877557,3882661,2022-12-28_21-32-14-189411,3882670,5104,
3882687,3882722,2022-12-28_21-32-19-356943,3882727,35,
3887780,3887820,2022-12-28_21-32-24-581251,3887823,40,
3892906,3892969,2022-12-28_21-32-29-838321,3892973,63,
3898010,3898034,2022-12-28_21-32-35-034619,3898037,24,
3903170,3903226,2022-12-28_21-32-40-345678,3903229,56,
3908278,3908329,2022-12-28_21-32-45-571663,3908332,51,
3913385,3913436,2022-12-28_21-32-50-801658,3913441,51,
3918493,3918542,2022-12-28_21-32-56-016097,3918547,49,
3923601,3923650,2022-12-28_21-33-01-248021,3923655,49,
3928740,3928767,2022-12-28_21-33-06-492429,3928770,27,
3933851,3933875,2022-12-28_21-33-11-719742,3933878,24,
3938982,3939004,2022-12-28_21-33-16-966458,3939007,22,
3944099,3944135,2022-12-28_21-33-22-218721,3944138,36,
3949197,3949218,2022-12-28_21-33-27-430150,3949221,21,
3954337,3954363,2022-12-28_21-33-32-691453,3954367,26,
3959482,3959502,2022-12-28_21-33-37-951369,3959505,20,
3964599,3964667,2022-12-28_21-33-43-222980,3964673,68,
3969697,3969719,2022-12-28_21-33-48-414926,3969722,22,
3974846,3974867,2022-12-28_21-33-53-677396,3974869,21,
3979958,3980061,2022-12-28_21-33-58-997403,3980064,103,
3985123,3985150,2022-12-28_21-34-04-212336,3985154,27,
3990232,3990265,2022-12-28_21-34-09-434287,3990268,33,
3995339,3995379,2022-12-28_21-34-14-660778,3995382,40,
4000456,4000477,2022-12-28_21-34-19-887966,4000481,21,
4005556,4005577,2022-12-28_21-34-25-116585,4005580,21,
4010707,4010778,2022-12-28_21-34-30-430560,4010781,71,
4015828,4015879,2022-12-28_21-34-35-648899,4015882,51,
4020949,4020974,2022-12-28_21-34-40-870928,4020977,25,
4026069,4026090,2022-12-28_21-34-46-110955,4026092,21,
4031176,4031196,2022-12-28_21-34-51-334600,4031199,20,
4036304,4036325,2022-12-28_21-34-56-582977,4036328,21,
4041412,4041433,2022-12-28_21-35-01-818968,4041436,21,
4046520,4046541,2022-12-28_21-35-07-042054,4046544,21,
4051627,4051647,2022-12-28_21-35-12-272059,4051650,20,
4056762,0,,4056799,-4056762,
4061887,4061907,2022-12-28_21-35-22-771171,4061911,20,
4067000,4067027,2022-12-28_21-35-28-009917,4067030,27,
4072133,4072207,2022-12-28_21-35-33-309928,4072213,74,
4077269,4077305,2022-12-28_21-35-38-531842,4077310,36,
4082405,4082427,2022-12-28_21-35-43-771025,4082430,22,
4087515,4087538,2022-12-28_21-35-49-001319,4087541,23,
4092640,4092717,2022-12-28_21-35-54-300986,4092722,77,
4097768,4097790,2022-12-28_21-35-59-494674,4097794,22,
4102893,4102928,2022-12-28_21-36-04-749358,4102933,35,
4108024,4108045,2022-12-28_21-36-09-996895,4108048,21,
4113135,4113156,2022-12-28_21-36-15-230705,4113159,21,
4118250,4118280,2022-12-28_21-36-20-474661,4118282,30,
4123379,4123416,2022-12-28_21-36-25-737660,4123419,37,
4128486,4128524,2022-12-28_21-36-30-956977,4128526,38,
4133620,4133641,2022-12-28_21-36-36-192437,4133644,21,
4138729,4138836,2022-12-28_21-36-41-504654,4143837,107,
4143849,4143869,2022-12-28_21-36-46-664118,4143872,20,
4148970,4149033,2022-12-28_21-36-51-952648,4149036,63,
4154096,4154142,2022-12-28_21-36-57-175377,4154145,46,
4159253,4159273,2022-12-28_21-37-02-429917,4159276,20,
4164391,4164445,2022-12-28_21-37-07-726704,4164455,54,
4169514,4169550,2022-12-28_21-37-12-948639,4169553,36,
4174632,4174655,2022-12-28_21-37-18-172278,4174658,23,
4179734,4179760,2022-12-28_21-37-23-397920,4179767,26,
4184960,4185049,2022-12-28_21-37-28-816667,4185052,89,
4190068,4190140,2022-12-28_21-37-34-031835,4190143,72,
4195197,4195256,2022-12-28_21-37-39-262223,4195258,59,
4200324,4200364,2022-12-28_21-37-44-486303,4200369,40,
4205504,4205552,2022-12-28_21-37-49-806608,4205558,48,
4210611,4210667,2022-12-28_21-37-55-037410,4210672,56,
4215725,4215755,2022-12-28_21-38-00-241349,4215758,30,
4220824,4225945,2022-12-28_21-38-05-513437,4225953,5121,
4225966,4226010,2022-12-28_21-38-10-742388,4226013,44,
4231055,4231078,2022-12-28_21-38-15-926962,4231081,23,
4236185,4236205,2022-12-28_21-38-21-182140,4236208,20,
4241315,4241374,2022-12-28_21-38-26-470657,4241380,59,
4246423,4246485,2022-12-28_21-38-31-696372,4246490,62,
4251522,4251543,2022-12-28_21-38-36-886955,4251546,21,
4256666,4256689,2022-12-28_21-38-42-155120,4256692,23,
4261781,4261878,2022-12-28_21-38-47-458763,4261883,97,
4266897,4266991,2022-12-28_21-38-52-686123,4266996,94,
4272037,4272077,2022-12-28_21-38-57-901960,4272085,40,
4277155,4277186,2022-12-28_21-39-03-125577,4277191,31,
4282262,4282297,2022-12-28_21-39-08-356013,4282302,35,
4287369,4287389,2022-12-28_21-39-13-573722,4287392,20,
4292515,4292584,2022-12-28_21-39-18-890219,4292586,69,
4297615,4297635,2022-12-28_21-39-24-063886,4297638,20,
4302748,4302770,2022-12-28_21-39-29-311493,4302773,22,
4307865,4307892,2022-12-28_21-39-34-562369,4307895,27,
4312973,4313002,2022-12-28_21-39-39-793081,4313005,29,
4318108,4318138,2022-12-28_21-39-45-050587,4318140,30,
4323225,4323290,2022-12-28_21-39-50-328202,4323292,65,
4328330,4328401,2022-12-28_21-39-55-555770,4328405,71,
4333440,4333509,2022-12-28_21-40-00-781293,4333512,69,
4338548,4343677,2022-12-28_21-40-06-113080,4343681,5129,
4343681,4343704,2022-12-28_21-40-11-221753,4343708,23,
4348790,4348818,2022-12-28_21-40-16-455284,4348823,28,
4353937,4354003,2022-12-28_21-40-21-766630,4354008,66,
4359036,4359120,2022-12-28_21-40-26-993164,4359123,84,
4364153,4364206,2022-12-28_21-40-32-211284,4364209,53,
4369251,4369272,2022-12-28_21-40-37-392724,4369276,21,
4374359,4374379,2022-12-28_21-40-42-614111,4374382,20,
4379501,4379524,2022-12-28_21-40-47-882751,4379527,23,
4384621,0,,4384725,-4384621,
4389748,4389768,2022-12-28_21-40-58-374200,4389770,20,
4394898,4394919,2022-12-28_21-41-03-638167,4394922,21,
4400036,4400137,2022-12-28_21-41-08-902277,4400140,101,
4405143,4410256,2022-12-28_21-41-14-242368,4410272,5113,
4410293,4410324,2022-12-28_21-41-19-417926,4410327,31,
4415370,4420466,2022-12-28_21-41-24-642189,4420468,5096,
4420469,4420489,2022-12-28_21-41-29-825461,4420492,20,
4425597,4430739,2022-12-28_21-41-35-218045,4430741,5142,
4430742,4430761,2022-12-28_21-41-40-331407,4430764,19,
4435873,4435941,2022-12-28_21-41-45-642944,4435944,68,
4441012,4441041,2022-12-28_21-41-50-863997,4441044,29,
4446161,4446184,2022-12-28_21-41-56-120612,4446186,23,
4451269,4456380,2022-12-28_21-42-01-339527,4456389,5111,
4456402,4461528,2022-12-28_21-42-06-650868,4461537,5126,
4461550,4461570,2022-12-28_21-42-11-874864,4461573,20,
4466657,4466677,2022-12-28_21-42-17-103812,4466681,20,
4471780,4471864,2022-12-28_21-42-22-403343,4471867,84,
4476890,4476913,2022-12-28_21-42-27-581393,4476915,23,
4482028,0,,4482058,-4482028,
4487143,4487165,2022-12-28_21-42-38-072270,4487168,22,
4492248,4492271,2022-12-28_21-42-43-303509,4492274,23,
4497355,4497381,2022-12-28_21-42-48-534595,4497384,26,
4502467,4502489,2022-12-28_21-42-53-763434,4502497,22,
4507577,4507609,2022-12-28_21-42-58-991943,4507612,32,
4512703,4512724,2022-12-28_21-43-04-237704,4512727,21,
4517812,4517833,2022-12-28_21-43-09-465520,4517836,21,
4522931,4522953,2022-12-28_21-43-14-707521,4522956,22,
4528064,4528087,2022-12-28_21-43-19-956445,4528090,23,
4533217,4533296,2022-12-28_21-43-25-287062,4533302,79,
4538350,4538370,2022-12-28_21-43-30-489550,4538372,20,
4543475,4543508,2022-12-28_21-43-35-746314,4543511,33,
4548589,4548614,2022-12-28_21-43-40-972610,4548617,25,
4553698,4553722,2022-12-28_21-43-46-211259,4553725,24,
4558814,4558898,2022-12-28_21-43-51-509480,4558901,84,
4563944,4563996,2022-12-28_21-43-56-717006,4564001,52,
4569082,4569109,2022-12-28_21-44-01-954168,4569111,27,
4574194,4574216,2022-12-28_21-44-07-182717,4574219,22,
4579315,4579339,2022-12-28_21-44-12-429212,4579341,24,
4584437,4584502,2022-12-28_21-44-17-712853,4584505,65,
4589571,4589608,2022-12-28_21-44-22-936925,4589611,37,
4594679,4594702,2022-12-28_21-44-28-153552,4594704,23,
4599781,4599808,2022-12-28_21-44-33-380536,4599811,27,
4604888,4604910,2022-12-28_21-44-38-602322,4604913,22,
4609994,4610015,2022-12-28_21-44-43-826099,4610019,21,
4615128,4615218,2022-12-28_21-44-49-147097,4615224,90,
4620250,4620273,2022-12-28_21-44-54-328998,4620276,23,
4625360,4625405,2022-12-28_21-44-59-586500,4625408,45,
4630477,4630507,2022-12-28_21-45-04-805397,4630510,30,
4635586,4635607,2022-12-28_21-45-10-028065,4635610,21,
4640720,4640741,2022-12-28_21-45-15-284400,4640743,21,
4645827,4650941,2022-12-28_21-45-20-578605,4650949,5114,
4650961,4650983,2022-12-28_21-45-25-760878,4650987,22,
4656061,4656126,2022-12-28_21-45-31-027986,4656131,65,
4661170,4661223,2022-12-28_21-45-36-246617,4661226,53,
4666276,4666338,2022-12-28_21-45-41-476822,4666341,62,
4671384,4671445,2022-12-28_21-45-46-697613,4671450,61,
4676492,4676538,2022-12-28_21-45-51-916294,4676543,46,
4681591,4681612,2022-12-28_21-45-57-114889,4681615,21,
4686729,4686749,2022-12-28_21-46-02-369354,4686751,20,
4691832,4691856,2022-12-28_21-46-07-604074,4691859,24,
4696980,4697046,2022-12-28_21-46-12-916689,4697051,66,