RD,TS_received,TS_sent,AK,RoundTrip,
117497,122613,2023-11-16_09-05-30-160881,122622,5116,
122634,127722,2023-11-16_09-05-35-509793,127730,5088,
127743,127764,2023-11-16_09-05-40-438854,127767,21,
132832,137952,2023-11-16_09-05-45-834593,137960,5120,
137972,143087,2023-11-16_09-05-51-321030,143096,5115,
143109,148218,2023-11-16_09-05-56-513934,148221,5109,
148221,153332,2023-11-16_09-06-02-444341,153335,5111,
153335,158441,2023-11-16_09-06-07-856155,158443,5106,
158444,0,,163542,-158444,
163542,168668,2023-11-16_09-06-18-759799,168671,5126,
168671,173778,2023-11-16_09-06-24-595591,173781,5107,
173781,0,,178888,-173781,
178900,184046,2023-11-16_09-06-35-117793,184049,5146,
184050,189195,2023-11-16_09-06-40-414778,189205,5145,
189217,0,,194333,-189217,
194345,199457,2023-11-16_09-06-50-292163,199467,5112,
199479,204573,2023-11-16_09-06-55-207239,204581,5094,
204593,209679,2023-11-16_09-07-00-824751,209681,5086,
209682,214788,2023-11-16_09-07-05-743635,214797,5106,
214809,219919,2023-11-16_09-07-11-200649,219922,5110,
219922,
225022,
230130,
235238,240364,2023-11-16_09-07-33-054410,240367,5126,
240367,245509,2023-11-16_09-07-38-373859,245518,5142,
245530,250651,2023-11-16_09-07-43-595665,250654,5121,
250654,255769,2023-11-16_09-07-48-314324,255772,5115,
255772,260909,2023-11-16_09-07-53-579728,260911,5137,
260912,266010,2023-11-16_09-07-59-113178,266019,5098,
266031,271141,2023-11-16_09-08-04-028063,271151,5110,
271163,276292,2023-11-16_09-08-10-017428,276296,5129,
276297,281436,2023-11-16_09-08-14-513249,281445,5139,
281457,286543,2023-11-16_09-08-19-844715,286552,5086,
286564,291652,2023-11-16_09-08-24-270714,291661,5088,
291673,
296778,301897,2023-11-16_09-08-35-889008,301905,5119,
301917,307004,2023-11-16_09-08-40-792916,307014,5087,
307026,312112,2023-11-16_09-08-45-243969,312121,5086,
312134,317339,2023-11-16_09-08-51-085188,317342,5205,
317342,
322439,
327547,332665,2023-11-16_09-09-07-080142,332667,5118,
332668,
337783,342909,2023-11-16_09-09-17-918930,342912,5126,
342913,
348021,353137,2023-11-16_09-09-28-093735,353146,5116,
353158,358276,2023-11-16_09-09-33-429466,358280,5118,
358281,363382,2023-11-16_09-09-38-402345,363392,5101,
363404,
368507,373624,2023-11-16_09-09-49-594505,373626,5117,
373627,378731,2023-11-16_09-09-54-230164,378734,5104,
378734,383846,2023-11-16_09-09-58-879839,383854,5112,
383867,388984,2023-11-16_09-10-03-815616,388992,5117,
388997,394122,2023-11-16_09-10-09-797845,394130,5125,
394142,399251,2023-11-16_09-10-14-842459,399260,5109,
399272,404383,2023-11-16_09-10-20-218699,404392,5111,
404404,409491,2023-11-16_09-10-25-769490,409494,5087,
409494,
414599,419749,2023-11-16_09-10-36-473140,419758,5150,
419770,
424857,
429965,435100,2023-11-16_09-10-51-560660,435103,5135,
435103,440206,2023-11-16_09-10-56-584054,440209,5103,
440210,445356,2023-11-16_09-11-02-418523,445365,5146,
445376,450465,2023-11-16_09-11-07-095987,450468,5089,
450468,455572,2023-11-16_09-11-12-003481,455580,5104,
455593,460699,2023-11-16_09-11-17-786216,460702,5106,
460702,465829,2023-11-16_09-11-22-662145,465832,5127,
465832,470936,2023-11-16_09-11-27-574873,470945,5104,
470957,476067,2023-11-16_09-11-33-526922,476070,5110,
476071,
481167,486284,2023-11-16_09-11-43-281403,486286,5117,
486287,491420,2023-11-16_09-11-48-866290,491424,5133,
491424,496542,2023-11-16_09-11-54-140626,496552,5118,
496564,501672,2023-11-16_09-11-59-672694,501680,5108,
501693,506803,2023-11-16_09-12-05-023776,506814,5110,
506826,0,,511911,-506826,
511924,
517029,
522137,
527267,
532405,537522,2023-11-16_09-12-37-472568,537531,5117,
537543,
542646,547762,2023-11-16_09-12-47-392444,547771,5116,
547783,0,,552893,-547783,
552893,558015,2023-11-16_09-12-57-438222,558017,5122,
558018,0,,563122,-558018,
563122,
568227,573346,2023-11-16_09-13-13-055463,573355,5119,
573368,578479,2023-11-16_09-13-18-261712,578488,5111,
578500,583588,2023-11-16_09-13-23-822348,583596,5088,
583609,588732,2023-11-16_09-13-29-294504,588735,5123,
588735,0,,593860,-588735,
593871,
598973,604089,2023-11-16_09-13-44-231755,604092,5116,
604092,609237,2023-11-16_09-13-48-789651,609240,5145,
609240,614354,2023-11-16_09-13-53-977620,614364,5114,
614377,619463,2023-11-16_09-13-59-157104,619465,5086,
619466,0,,624604,-619466,
624616,629721,2023-11-16_09-14-10-012515,629730,5105,
629742,634848,2023-11-16_09-14-14-982013,634851,5106,
634851,634883,2023-11-16_09-14-19-668288,634887,32,
639965,
645089,
650200,655322,2023-11-16_09-14-36-797541,655324,5122,
655325,0,,660433,-655325,
660433,665547,2023-11-16_09-14-47-547487,665556,5114,
665568,
670678,675798,2023-11-16_09-14-58-031610,675801,5120,
675801,680909,2023-11-16_09-15-03-137699,680912,5108,
680912,686029,2023-11-16_09-15-06-809822,686032,5117,
686032,691130,2023-11-16_09-15-13-678869,691139,5098,
691152,696251,2023-11-16_09-15-17-953368,696260,5099,
696272,
701382,
706490,0,,711625,-706490,
711625,716747,2023-11-16_09-15-40-848380,716749,5122,
716750,
721841,
726949,
732070,
737206,0,,742316,-737206,
742316,
747438,
752546,
757654,762799,2023-11-16_09-16-26-723034,762808,5145,
762820,767921,2023-11-16_09-16-30-749214,767930,5101,
767942,773061,2023-11-16_09-16-37-157951,773064,5119,
773065,778206,2023-11-16_09-16-41-863369,778209,5141,
778209,783342,2023-11-16_09-16-48-129236,783345,5133,
783345,0,,788455,-783345,
788456,793596,2023-11-16_09-16-59-033299,793604,5140,
793616,798702,2023-11-16_09-17-04-305517,798711,5086,
798724,803825,2023-11-16_09-17-09-626511,803834,5101,
803846,
808939,
814047,819172,2023-11-16_09-17-25-163673,819181,5125,
819193,
831080,0,,836190,-831080,
836190,841316,2023-11-16_09-17-46-024364,841325,5126,
841337,841357,2023-11-16_09-17-51-059934,841360,20,
846426,846517,2023-11-16_09-17-56-339085,846520,91,
851535,851558,2023-11-16_09-18-01-506045,851561,23,
856656,861767,2023-11-16_09-18-07-028425,861776,5111,
861788,867011,2023-11-16_09-18-12-056977,867013,5223,
867014,867036,2023-11-16_09-18-17-353279,867039,22,
872131,872152,2023-11-16_09-18-22-592593,872156,21,
877238,882367,2023-11-16_09-18-28-168911,882377,5129,
882389,882412,2023-11-16_09-18-33-097746,882414,23,
887479,887507,2023-11-16_09-18-38-314688,887510,28,
892633,892654,2023-11-16_09-18-43-583080,892657,21,
897742,
902871,908012,2023-11-16_09-18-55-694642,908020,5141,
908032,0,,913147,-908032,
913147,
918252,0,,923362,-918252,
923362,
928468,933602,2023-11-16_09-19-22-011982,933611,5134,
933623,938731,2023-11-16_09-19-26-464137,938739,5108,
938751,943846,2023-11-16_09-19-30-813987,943854,5095,
943866,948954,2023-11-16_09-19-37-083846,948957,5088,
948957,954061,2023-11-16_09-19-43-131061,954070,5104,
954082,959195,2023-11-16_09-19-48-349634,959198,5113,
959199,964305,2023-11-16_09-19-52-703121,964314,5106,
964326,969412,2023-11-16_09-19-57-549800,969421,5086,
969434,969535,2023-11-16_09-20-02-264119,969538,101,
974552,979668,2023-11-16_09-20-07-976184,979672,5116,
979672,984785,2023-11-16_09-20-13-731380,984788,5113,
984788,989916,2023-11-16_09-20-18-623628,989926,5128,
989938,995059,2023-11-16_09-20-23-875944,995063,5121,
995063,1000185,2023-11-16_09-20-29-294284,1000195,5122,
1000207,1005293,2023-11-16_09-20-34-666051,1005296,5086,
1005296,1010401,2023-11-16_09-20-39-619709,1010410,5105,
1010423,
1015521,1020640,2023-11-16_09-20-51-049143,1020649,5119,
1020661,1025765,2023-11-16_09-20-55-932425,1025774,5104,
1025787,1030911,2023-11-16_09-21-00-245601,1030921,5124,
1030933,1036019,2023-11-16_09-21-05-356043,1036027,5086,
1036040,1041166,2023-11-16_09-21-10-511576,1041176,5126,
1041189,1046275,2023-11-16_09-21-15-685696,1046284,5086,
1046296,1051383,2023-11-16_09-21-21-332391,1051392,5087,
1051404,1051424,2023-11-16_09-21-26-143493,1051427,20,
1056494,
1061600,
1066725,
1071833,
1076952,
1082101,
1087210,
1092322,1097453,2023-11-16_09-22-09-823764,1097456,5131,
1097457,
1102562,1107678,2023-11-16_09-22-19-301173,1107680,5116,
1107681,
1112783,
1117891,
1133484,
1138592,
1143700,1148822,2023-11-16_09-23-02-450225,1148832,5122,
1148844,1153929,2023-11-16_09-23-08-390603,1153932,5085,
1153933,
1159063,1164185,2023-11-16_09-23-18-633655,1164189,5122,
1164189,1169295,2023-11-16_09-23-23-789555,1169303,5106,
1169315,
1174409,
1179517,1184672,2023-11-16_09-23-39-501523,1184681,5155,
1184693,
1189772,
1194883,1199999,2023-11-16_09-23-54-606978,1200008,5116,
1200021,1205133,2023-11-16_09-24-00-308685,1205136,5112,
1205136,
1210248,
1215356,1220472,2023-11-16_09-24-15-181004,1220481,5116,
1220494,1225614,2023-11-16_09-24-19-679877,1225624,5120,
1225636,1230734,2023-11-16_09-24-24-966599,1230742,5098,
1230754,1235857,2023-11-16_09-24-31-742216,1235860,5103,
1235860,1240972,2023-11-16_09-24-36-937675,1240981,5112,
1240994,1246123,2023-11-16_09-24-42-350519,1246126,5129,
1246126,1251248,2023-11-16_09-24-47-956761,1251251,5122,
1251251,
1256410,
1261515,1266720,2023-11-16_09-25-03-370644,1266723,5205,
1266724,1271828,2023-11-16_09-25-08-430569,1271836,5104,
1271849,
1276953,
1282061,
1287229,1292349,2023-11-16_09-25-29-974416,1292357,5120,
1292369,1297489,2023-11-16_09-25-34-885893,1297491,5120,
1297492,
1302599,1307742,2023-11-16_09-25-45-502599,1307751,5143,
1307763,1312861,2023-11-16_09-25-50-806422,1312870,5098,
1312883,1318000,2023-11-16_09-25-55-054417,1318008,5117,
1318020,1323106,2023-11-16_09-26-00-359966,1323115,5086,
1323127,
1328240,
1333356,
1338464,1343580,2023-11-16_09-26-21-987115,1343595,5116,
1343608,
1348715,1353831,2023-11-16_09-26-33-415229,1353834,5116,
1353834,1358938,2023-11-16_09-26-38-101651,1358941,5104,
1358942,1364047,2023-11-16_09-26-43-022811,1364056,5105,
1364068,1369195,2023-11-16_09-26-47-851791,1369197,5127,
1369198,1374296,2023-11-16_09-26-53-527768,1374299,5098,
1374299,1379408,2023-11-16_09-26-59-011879,1379411,5109,
1379411,1384521,2023-11-16_09-27-04-614493,1384524,5110,
1384524,
1389625,1394792,2023-11-16_09-27-12-437157,1394801,5167,
1394813,1399880,2023-11-16_09-27-20-143947,1399883,5067,
1399884,1405000,2023-11-16_09-27-25-462988,1405003,5116,
1405004,1410128,2023-11-16_09-27-30-484282,1410131,5124,
1410131,1415245,2023-11-16_09-27-35-169522,1415261,5114,
1415273,1420388,2023-11-16_09-27-38-809563,1420397,5115,
1420410,1425497,2023-11-16_09-27-44-555185,1425499,5087,
1425500,
1430596,1435712,2023-11-16_09-27-56-858417,1435715,5116,
1435715,1440850,2023-11-16_09-28-01-674281,1440859,5135,
1440872,1446006,2023-11-16_09-28-07-316090,1446021,5134,
1446033,
1451145,1456260,2023-11-16_09-28-17-211605,1456270,5115,
1456282,1461382,2023-11-16_09-28-22-948829,1461386,5100,
1461386,
1466519,
1471632,
1476740,1481866,2023-11-16_09-28-44-304586,1481869,5126,
1481870,1486982,2023-11-16_09-28-49-547197,1486985,5112,
1486986,1492103,2023-11-16_09-28-54-605534,1492112,5117,
1492123,1497230,2023-11-16_09-28-59-076570,1497238,5107,
1497252,
1502354,1507542,2023-11-16_09-29-07-866729,1507551,5188,
1507564,
1512582,1517703,2023-11-16_09-29-20-396991,1517711,5121,
1517723,
1522813,
1527921,
1533057,
1559610,0,,1564720,-1559610,
1564720,1564750,2023-11-16_09-30-11-716192,1564753,30,
1569837,
1574934,1580098,2023-11-16_09-30-22-477099,1580107,5164,
1580110,1585210,2023-11-16_09-30-28-457577,1585213,5100,
1585213,
1590310,1595429,2023-11-16_09-30-40-869256,1595431,5119,
1595432,1600536,2023-11-16_09-30-45-507552,1600539,5104,
1600539,1605645,2023-11-16_09-30-50-083653,1605654,5106,
1605666,1610784,2023-11-16_09-30-55-693889,1610792,5118,
1610805,
1615907,
1621030,1626165,2023-11-16_09-31-11-851308,1626174,5135,
1626186,1631299,2023-11-16_09-31-17-023510,1631303,5113,
1631303,1636407,2023-11-16_09-31-22-419007,1636410,5104,
1636410,1641525,2023-11-16_09-31-27-122169,1641534,5115,
1641546,
1646662,1651778,2023-11-16_09-31-37-579673,1651781,5116,
1651781,1656902,2023-11-16_09-31-43-173244,1656905,5121,
1656905,1662011,2023-11-16_09-31-48-668444,1662019,5106,
1662032,
1667144,1672273,2023-11-16_09-31-59-154636,1672276,5129,
1672276,
1677371,
1682479,1687596,2023-11-16_09-32-14-118420,1687604,5117,
1687616,0,,1692726,-1687616,
1692726,1697862,2023-11-16_09-32-25-461875,1697865,5136,
1697865,
1702982,1708105,2023-11-16_09-32-35-974969,1708108,5123,
1708108,1713223,2023-11-16_09-32-41-225064,1713226,5115,
1713226,1718331,2023-11-16_09-32-45-845622,1718340,5105,
1718352,1723439,2023-11-16_09-32-50-885574,1723442,5087,
1723442,1728547,2023-11-16_09-32-55-766154,1728556,5105,
1728568,1733685,2023-11-16_09-33-01-430855,1733693,5117,
1733705,1738791,2023-11-16_09-33-06-282930,1738800,5086,
1738812,1743923,2023-11-16_09-33-11-432981,1743932,5111,
1743944,1749050,2023-11-16_09-33-17-147771,1749059,5106,
1749071,1754157,2023-11-16_09-33-22-313447,1754166,5086,
1754178,1759265,2023-11-16_09-33-27-523011,1759275,5087,
1759287,0,,1764373,-1759287,
1764386,1769494,2023-11-16_09-33-37-940088,1769504,5108,
1769515,1774623,2023-11-16_09-33-43-134644,1774632,5108,
1774644,1779729,2023-11-16_09-33-48-523050,1779739,5085,
1779751,1784838,2023-11-16_09-33-53-575528,1784847,5087,
1784859,
1789945,1795067,2023-11-16_09-34-04-484715,1795076,5122,
1795088,1800211,2023-11-16_09-34-08-908334,1800220,5123,
1800232,1805347,2023-11-16_09-34-14-642996,1805355,5115,
1805368,1810461,2023-11-16_09-34-19-564176,1810469,5093,
1810482,1815590,2023-11-16_09-34-24-475876,1815600,5108,
1815612,1820742,2023-11-16_09-34-30-082378,1820744,5130,
1820746,1825892,2023-11-16_09-34-35-090599,1825900,5146,
1825913,1831030,2023-11-16_09-34-39-467196,1831038,5117,
1831050,1836174,2023-11-16_09-34-44-535283,1836184,5124,
1836196,1841281,2023-11-16_09-34-49-971496,1841290,5085,
1841303,1846392,2023-11-16_09-34-56-029499,1846395,5089,
1846395,1851500,2023-11-16_09-35-01-249331,1851503,5105,
1851503,1856624,2023-11-16_09-35-05-617344,1856632,5121,
1856644,1861766,2023-11-16_09-35-11-442763,1861774,5122,
1861786,
1866877,1871993,2023-11-16_09-35-21-804320,1872002,5116,
1872014,1877101,2023-11-16_09-35-27-590916,1877110,5087,
1877123,1882246,2023-11-16_09-35-33-098452,1882254,5123,
1882266,
1887345,0,,1892489,-1887345,
1892490,
1897598,
1902721,
1907829,
1912937,
1923127,
1928235,
1933343,1938459,2023-11-16_09-36-30-627989,1938468,5116,
1938481,1943594,2023-11-16_09-36-35-629008,1943603,5113,
1943616,1948747,2023-11-16_09-36-41-893308,1948756,5131,
1948768,
1953863,1958982,2023-11-16_09-36-52-220448,1958985,5119,
1958986,
1964088,
1969213,0,,1974316,-1969213,
1974317,1979428,2023-11-16_09-37-11-133330,1979437,5111,
1979450,1984538,2023-11-16_09-37-18-467941,1984540,5088,
1984541,
1989647,
1994755,
1999863,2004999,2023-11-16_09-37-39-299592,2005007,5136,
2005019,2010138,2023-11-16_09-37-45-003686,2010141,5119,
2010141,2015248,2023-11-16_09-37-50-324846,2015257,5107,
2015269,
2020348,
2025463,
2030578,
2035686,
2040794,
2045902,2051028,2023-11-16_09-38-25-830176,2051036,5126,
2051048,2056164,2023-11-16_09-38-30-273231,2056173,5116,
2056185,2061308,2023-11-16_09-38-35-479979,2061311,5123,
2061311,0,,2066409,-2061311,
2066409,2071523,2023-11-16_09-38-47-598966,2071526,5114,
2071527,
2076630,
2081754,
2124795,
2129908,2135024,2023-11-16_09-39-51-585138,2135026,5116,
2135027,2140143,2023-11-16_09-39-55-707886,2140152,5116,
2140164,2145284,2023-11-16_09-40-02-924570,2145289,5120,
2145290,
2150400,
2155508,
2169237,
2174345,2179471,2023-11-16_09-40-37-039735,2179473,5126,
2179474,2184583,2023-11-16_09-40-41-827645,2184586,5109,
2184587,
2189682,
2194790,
2199898,
2205023,2210139,2023-11-16_09-41-09-614402,2210143,5116,
2210143,2215250,2023-11-16_09-41-14-265999,2215258,5107,
2215270,
2220380,2225496,2023-11-16_09-41-25-669838,2225499,5116,
2225500,2230633,2023-11-16_09-41-30-407113,2230642,5133,
2230655,
2235762,
2240879,
2245997,2251123,2023-11-16_09-41-51-797691,2251133,5126,
2251145,2256231,2023-11-16_09-41-56-388833,2256234,5086,
2256234,2261373,2023-11-16_09-42-02-122462,2261377,5139,
2261377,0,,2266475,-2261377,
2266475,
2271588,
2276696,2281813,2023-11-16_09-42-23-113484,2281815,5117,
2281816,
2286927,0,,2292048,-2286927,
2292048,2297201,2023-11-16_09-42-39-029871,2297211,5153,
2297211,2302307,2023-11-16_09-42-43-433173,2302317,5096,
2302329,2307467,2023-11-16_09-42-48-620429,2307475,5138,
2307487,
2312566,
2317674,2322794,2023-11-16_09-43-04-761412,2322797,5120,
2322797,2327900,2023-11-16_09-43-10-124791,2327903,5103,
2327904,2333009,2023-11-16_09-43-15-283081,2333018,5105,
2333031,
2338149,
2343257,2348373,2023-11-16_09-43-30-841206,2348381,5116,
2348393,0,,2353502,-2348393,
2353502,0,,2358612,-2353502,
2358613,2363725,2023-11-16_09-43-47-291263,2363728,5112,
2363729,2368840,2023-11-16_09-43-52-374661,2368849,5111,
2368861,2373997,2023-11-16_09-43-56-610523,2374000,5136,
2374001,2379120,2023-11-16_09-44-02-178896,2379130,5119,
2379143,2384228,2023-11-16_09-44-08-132333,2384237,5085,
2384250,2389352,2023-11-16_09-44-13-418377,2389355,5102,
2389356,2394480,2023-11-16_09-44-18-530265,2394483,5124,
2394483,
2399583,
2404691,2409825,2023-11-16_09-44-34-003401,2409834,5134,
2409845,
2414907,
2420017,2425133,2023-11-16_09-44-48-584964,2425136,5116,
2425136,
2430240,
2435360,
2440468,0,,2445580,-2440468,
2445580,2450704,2023-11-16_09-45-16-000820,2450707,5124,
2450707,0,,2455821,-2450707,
2455822,
2460927,
2466034,2471150,2023-11-16_09-45-36-815091,2471153,5116,
2471153,2476283,2023-11-16_09-45-41-632300,2476292,5130,
2476304,2481384,2023-11-16_09-45-47-567695,2481393,5080,
2481404,2486492,2023-11-16_09-45-52-664342,2486501,5088,
2486513,2491642,2023-11-16_09-45-57-460935,2491646,5129,
2491646,
2496755,
2501863,2506997,2023-11-16_09-46-13-999582,2507007,5134,
2507019,
2512083,2517240,2023-11-16_09-46-24-232628,2517242,5157,
2517243,
2522339,
2527447,2532564,2023-11-16_09-46-40-109733,2532566,5117,
2532567,2537691,2023-11-16_09-46-44-865796,2537700,5124,
2537712,2542798,2023-11-16_09-46-50-064672,2542808,5086,
2542819,2547930,2023-11-16_09-46-55-357211,2547933,5111,
2547933,2553044,2023-11-16_09-47-00-356412,2553047,5111,
2553047,2558151,2023-11-16_09-47-06-042518,2558154,5104,
2558155,
2563264,
2568372,
2573495,
2578622,
2583734,
2588842,2593958,2023-11-16_09-47-42-568497,2593966,5116,
2593969,2599078,2023-11-16_09-47-47-581289,2599081,5109,
2599081,2604201,2023-11-16_09-47-53-146622,2604203,5120,
2604204,2609332,2023-11-16_09-47-57-955480,2609341,5128,
2609353,2614474,2023-11-16_09-48-03-253342,2614483,5121,
2614495,2619583,2023-11-16_09-48-08-466669,2619586,5088,
2619586,2624712,2023-11-16_09-48-13-308642,2624714,5126,
2624715,0,,2629842,-2624715,
2629843,2634960,2023-11-16_09-48-24-609276,2634969,5117,
2634981,2640084,2023-11-16_09-48-29-747604,2640093,5103,
2640106,2645223,2023-11-16_09-48-35-569585,2645225,5117,
2645226,
2650321,2655438,2023-11-16_09-48-45-644176,2655447,5117,
2655460,
2660537,0,,2665647,-2660537,
2665647,
2670753,
2675873,2680989,2023-11-16_09-49-11-393122,2680998,5116,
2681010,2686120,2023-11-16_09-49-17-124612,2686123,5110,
2686123,
2691262,2696391,2023-11-16_09-49-26-860171,2696400,5129,
2696403,2701510,2023-11-16_09-49-32-953053,2701513,5107,
2701513,
2706634,2711750,2023-11-16_09-49-40-941605,2711759,5116,
2711762,2716894,2023-11-16_09-49-48-846769,2716904,5132,
2716916,2722001,2023-11-16_09-49-53-245815,2722005,5085,
2722005,2727110,2023-11-16_09-49-58-250309,2727113,5105,
2727114,2732235,2023-11-16_09-50-03-450140,2732237,5121,
2732238,2737351,2023-11-16_09-50-08-638344,2737354,5113,
2737354,0,,2742470,-2737354,
2742471,2747586,2023-11-16_09-50-19-130897,2747595,5115,
2747607,2752709,2023-11-16_09-50-24-805967,2752717,5102,
2752730,2757815,2023-11-16_09-50-30-787446,2757819,5085,
2757819,2762927,2023-11-16_09-50-35-012116,2762936,5108,
2762949,2768080,2023-11-16_09-50-39-701851,2768082,5131,
2768083,2773193,2023-11-16_09-50-46-000045,2773203,5110,
2773215,2778340,2023-11-16_09-50-50-698929,2778350,5125,
2778362,2783477,2023-11-16_09-50-56-261195,2783485,5115,
2783497,
2788576,2793692,2023-11-16_09-51-07-383834,2793695,5116,
2793695,2798801,2023-11-16_09-51-12-657824,2798804,5106,
2798804,
2803913,2809052,2023-11-16_09-51-20-529455,2809061,5139,
2809073,
2814185,2819301,2023-11-16_09-51-33-330226,2819310,5116,
2819322,2824410,2023-11-16_09-51-38-586933,2824412,5088,
2824413,
2829509,2834643,2023-11-16_09-51-49-595115,2834646,5134,
2834646,
2839725,
2844833,
2849945,
2855053,
2860237,
2865338,
2870446,
2875565,
2880681,
2885821,
2890899,
2896007,
2901115,
2906228,
2911363,
2916465,
2921573,
2926681,
2931789,
2936951,
2942059,
2947175,2952296,2023-11-16_09-53-49-822155,2952298,5121,
2952299,2957422,2023-11-16_09-53-54-589518,2957430,5123,
2957443,2962530,2023-11-16_09-54-00-348894,2962539,5087,
2962551,2967638,2023-11-16_09-54-05-344390,2967640,5087,
2967641,2972773,2023-11-16_09-54-10-256908,2972777,5132,
2972777,2977900,2023-11-16_09-54-14-877605,2977909,5123,
2977922,2983009,2023-11-16_09-54-19-575232,2983017,5087,
2983036,0,,2988152,-2983036,
2988164,2993270,2023-11-16_09-54-30-500836,2993279,5106,
2993291,2998377,2023-11-16_09-54-35-516353,2998379,5086,
2998380,3003502,2023-11-16_09-54-41-862731,3003511,5122,
3003522,0,,3008640,-3003522,
3008640,
3013745,3018862,2023-11-16_09-54-57-256962,3018865,5117,
3018865,3023970,2023-11-16_09-55-02-661825,3023979,5105,
3023991,3029097,2023-11-16_09-55-08-123489,3029099,5106,
3029100,
3034196,
3039305,
3044412,
3049520,
3054630,3059746,2023-11-16_09-55-39-662299,3059749,5116,
3059750,3064880,2023-11-16_09-55-45-024695,3064890,5130,
3064902,
3069999,
3075119,
3080244,
3085339,
3090447,
3177178,
3182292,3187409,2023-11-16_09-57-48-923159,3187411,5117,
3187412,3192524,2023-11-16_09-57-54-374400,3192532,5112,
3192544,3192621,2023-11-16_09-57-58-451182,3192625,77,
3197674,3202800,2023-11-16_09-58-03-715542,3202809,5126,
3202812,
3207909,3213025,2023-11-16_09-58-15-784718,3213028,5116,
3213028,3218141,2023-11-16_09-58-21-650874,3218143,5113,
3218144,
3223239,0,,3228372,-3223239,
3228385,
3233490,
3238606,3243729,2023-11-16_09-58-47-732986,3243737,5123,
3243749,
3248827,3253998,2023-11-16_09-58-57-986141,3254001,5171,
3254002,
3259098,
3264206,3269322,2023-11-16_09-59-13-964972,3269325,5116,
3269325,3274431,2023-11-16_09-59-19-030351,3274440,5106,
3274452,0,,3279532,-3274452,
3279532,3284656,2023-11-16_09-59-28-907142,3284659,5124,
3284659,
3289758,
3308572,
3313688,3318826,2023-11-16_10-00-02-999795,3318835,5138,
3318848,3323973,2023-11-16_10-00-08-673573,3323982,5125,
3323982,3329087,2023-11-16_10-00-14-124092,3329096,5105,
3329108,
3334211,
3339319,3344437,2023-11-16_10-00-30-253297,3344440,5118,
3344440,3349563,2023-11-16_10-00-36-045851,3349573,5123,
3349585,
3354663,
3359771,
3364879,0,,3369990,-3364879,
3369990,
3375095,
3380220,
3399821,
3404949,
3410058,3415204,2023-11-16_10-01-43-054402,3415208,5146,
3415208,3420336,2023-11-16_10-01-48-087401,3420344,5128,
3420356,0,,3425458,-3420356,
3425459,3430572,2023-11-16_10-01-59-151442,3430575,5113,
3430575,3435697,2023-11-16_10-02-04-025321,3435706,5122,
3435719,3440838,2023-11-16_10-02-09-070771,3440841,5119,
3440842,3445946,2023-11-16_10-02-14-159578,3445955,5104,
3445967,3451070,2023-11-16_10-02-20-229440,3451079,5103,
3451098,3456178,2023-11-16_10-02-25-178377,3456181,5080,
3456182,3461287,2023-11-16_10-02-30-559971,3461289,5105,
3461290,3466395,2023-11-16_10-02-35-948985,3466404,5105,
3466407,
3471503,0,,3476619,-3471503,
3476631,
3493117,
3498225,
3503333,
3508441,3513566,2023-11-16_10-03-23-550628,3513576,5125,
3513588,3518673,2023-11-16_10-03-29-055029,3518676,5085,
3518676,0,,3523786,-3518676,
3523786,
3528890,3534042,2023-11-16_10-03-44-652176,3534051,5152,
3534063,3539172,2023-11-16_10-03-50-369646,3539175,5109,
3539175,3544286,2023-11-16_10-03-55-333675,3544296,5111,
3544308,
3549402,3554521,2023-11-16_10-04-05-797998,3554530,5119,
3554542,0,,3559623,-3554542,
3559623,3564755,2023-11-16_10-04-16-072087,3564763,5132,
3564775,3569862,2023-11-16_10-04-21-202801,3569865,5087,
3569865,0,,3574969,-3569865,
3574970,3580084,2023-11-16_10-04-31-667388,3580092,5114,
3580096,3585239,2023-11-16_10-04-37-024161,3585242,5143,
3585242,3590340,2023-11-16_10-04-41-857267,3590349,5098,
3590362,3595491,2023-11-16_10-04-47-424090,3595494,5129,
3595494,0,,3600598,-3595494,
3600598,0,,3605707,-3600598,
3605707,
3610812,3615934,2023-11-16_10-05-08-283071,3615936,5122,
3615937,3621036,2023-11-16_10-05-13-446429,3621039,5099,
3621040,3626164,2023-11-16_10-05-18-399210,3626173,5124,
3626185,3631291,2023-11-16_10-05-23-419978,3631300,5106,
3631312,3636430,2023-11-16_10-05-28-335464,3636440,5118,
3636452,3641564,2023-11-16_10-05-34-604645,3641574,5112,
3641587,3646707,2023-11-16_10-05-39-547268,3646710,5120,
3646710,
3651817,3656984,2023-11-16_10-05-49-960844,3656987,5167,
3656989,3662092,2023-11-16_10-05-55-825222,3662101,5103,
3662113,
3667201,
3672309,
3677417,
3682525,
3687633,3692841,2023-11-16_10-06-28-082675,3692843,5208,
3692844,
3697968,
3703080,
3708223,3713331,2023-11-16_10-06-49-030195,3713334,5108,
3713334,3718457,2023-11-16_10-06-53-607065,3718460,5123,
3718460,3723575,2023-11-16_10-06-59-363844,3723578,5115,
3723578,3728682,2023-11-16_10-07-03-950447,3728685,5104,
3728685,0,,3733801,-3728685,
3733802,3738915,2023-11-16_10-07-14-898772,3738918,5113,
3738918,3744038,2023-11-16_10-07-19-949113,3744041,5120,
3744041,3749160,2023-11-16_10-07-24-808142,3749163,5119,
3749163,
3754287,
3759395,
3764513,0,,3769623,-3764513,
3769623,3774742,2023-11-16_10-07-51-409536,3774750,5119,
3774763,3779849,2023-11-16_10-07-55-982008,3779858,5086,
3779871,3784996,2023-11-16_10-08-01-935080,3784999,5125,
3784999,3790108,2023-11-16_10-08-06-552852,3790117,5109,
3790130,3795255,2023-11-16_10-08-12-219141,3795258,5125,
3795259,3800382,2023-11-16_10-08-17-653559,3800392,5123,
3800404,
3805507,3810623,2023-11-16_10-08-27-823888,3810625,5116,
3810626,
3815739,3820855,2023-11-16_10-08-38-606396,3820858,5116,
3820858,3825997,2023-11-16_10-08-43-937930,3826006,5139,
3826018,3831145,2023-11-16_10-08-49-106810,3831149,5127,
3831150,3836255,2023-11-16_10-08-54-926062,3836258,5105,
3836259,
3841376,3846502,2023-11-16_10-09-04-857710,3846517,5126,
3846529,
3851632,
3856740,3861855,2023-11-16_10-09-20-242915,3861859,5115,
3861859,3866970,2023-11-16_10-09-25-668802,3866979,5111,
3866997,
3872093,
3877201,3882339,2023-11-16_10-09-41-550486,3882342,5138,
3882343,3887447,2023-11-16_10-09-46-776229,3887450,5104,
3887450,3892558,2023-11-16_10-09-51-668346,3892561,5108,
3892561,3897682,2023-11-16_10-09-56-990120,3897690,5121,
3897703,3902790,2023-11-16_10-10-01-667563,3902792,5087,
3902793,0,,3907897,-3902793,
3907900,0,,3913015,-3907900,
3913015,3918138,2023-11-16_10-10-18-098426,3918140,5123,
3918141,3923246,2023-11-16_10-10-22-890621,3923249,5105,
3923249,
3928359,
3933467,3938606,2023-11-16_10-10-39-786254,3938609,5139,
3938609,
3943713,
3948817,3953933,2023-11-16_10-10-54-858888,3953936,5116,
3953936,3959057,2023-11-16_10-10-59-757984,3959060,5121,
3959060,3964169,2023-11-16_10-11-05-035393,3964172,5109,
3964172,
3969268,3974385,2023-11-16_10-11-15-958608,3974393,5117,
3974405,0,,3979511,-3974405,
3979523,
3984652,
3989787,3994911,2023-11-16_10-11-36-537045,3994920,5124,
3994932,4000065,2023-11-16_10-11-41-765777,4000074,5133,
4000086,0,,4005209,-4000086,
4005222,
4010308,4015427,2023-11-16_10-11-58-144783,4015430,5119,
4015431,4020534,2023-11-16_10-12-02-994703,4020538,5103,
4020538,0,,4025645,-4020538,
4025646,4030776,2023-11-16_10-12-13-849544,4030779,5130,
4030779,
4035896,4041012,2023-11-16_10-12-24-236977,4041027,5116,
4041039,4046124,2023-11-16_10-12-29-816304,4046127,5085,
4046127,
4051222,4056360,2023-11-16_10-12-40-032944,4056363,5138,
4056363,
4061472,4066595,2023-11-16_10-12-50-458928,4066603,5123,
4066604,4071716,2023-11-16_10-12-56-109746,4071725,5112,
4071737,
4076842,4081962,2023-11-16_10-13-06-141362,4081971,5120,
4081983,
4087061,4092201,2023-11-16_10-13-16-488405,4092204,5140,
4092204,4097341,2023-11-16_10-13-21-328734,4097344,5137,
4097345,
4102445,4107568,2023-11-16_10-13-32-471539,4107571,5123,
4107571,4112674,2023-11-16_10-13-38-124875,4112678,5103,
4112678,4117784,2023-11-16_10-13-43-115645,4117787,5106,
4117787,4122897,2023-11-16_10-13-48-373071,4122906,5110,
4122918,