RD,TS_received,TS_sent,AK,RoundTrip,
19606,19671,2022-12-29_17-43-17-158654,19676,65,
24728,24748,2022-12-29_17-43-22-375337,24751,20,
29867,29951,2022-12-29_17-43-27-703603,29954,84,
34965,35050,2022-12-29_17-43-32-919661,35053,85,
40080,40142,2022-12-29_17-43-38-132525,40145,62,
45192,45244,2022-12-29_17-43-43-365141,45247,52,
50298,50357,2022-12-29_17-43-48-604303,50361,59,
55424,55447,2022-12-29_17-43-53-812721,55449,23,
60560,60595,2022-12-29_17-43-59-081718,60599,35,
65677,65742,2022-12-29_17-44-04-349735,65745,65,
70784,70875,2022-12-29_17-44-09-584866,70880,91,
75907,75927,2022-12-29_17-44-14-777995,75930,20,
81054,81074,2022-12-29_17-44-20-046749,81077,20,
86162,86184,2022-12-29_17-44-25-282560,86187,22,
91269,91291,2022-12-29_17-44-30-520347,91295,22,
96415,96447,2022-12-29_17-44-35-797674,96450,32,
101514,101538,2022-12-29_17-44-41-013621,101540,24,
106653,106674,2022-12-29_17-44-46-273690,106677,21,
111810,111859,2022-12-29_17-44-51-576526,111865,49,
116914,116938,2022-12-29_17-44-56-789755,116941,24,
122045,122067,2022-12-29_17-45-02-047859,122070,22,
127178,127238,2022-12-29_17-45-07-344235,127240,60,
132285,132319,2022-12-29_17-45-12-549263,132322,34,
137384,137421,2022-12-29_17-45-17-779200,137424,37,
142543,142619,2022-12-29_17-45-23-110400,142624,76,
147663,147726,2022-12-29_17-45-28-338695,147731,63,
152771,157894,2022-12-29_17-45-33-695959,157907,5123,
157928,163062,2022-12-29_17-45-38-950466,163076,5134,
163088,163109,2022-12-29_17-45-44-104301,163112,21,
168175,173277,2022-12-29_17-45-49-326594,173288,5102,
173301,173395,2022-12-29_17-45-54-634953,173397,94,
178427,178452,2022-12-29_17-45-59-806604,178455,25,
183544,183609,2022-12-29_17-46-05-083571,183613,65,
188650,188723,2022-12-29_17-46-10-312490,188726,73,
193795,193828,2022-12-29_17-46-15-540086,193832,33,
198906,198928,2022-12-29_17-46-20-757286,198932,22,
204011,204032,2022-12-29_17-46-25-974010,204036,21,
209119,209142,2022-12-29_17-46-31-205094,209145,23,
214262,214335,2022-12-29_17-46-36-520798,214337,73,
219360,219437,2022-12-29_17-46-41-748821,219440,77,
224500,224538,2022-12-29_17-46-46-978161,224541,38,
229629,229649,2022-12-29_17-46-52-217164,229651,20,
234736,234757,2022-12-29_17-46-57-456441,234760,21,
239845,239887,2022-12-29_17-47-02-708235,239890,42,
245003,245023,2022-12-29_17-47-07-971126,245027,20,
250142,250164,2022-12-29_17-47-13-230618,250166,22,
255261,255345,2022-12-29_17-47-18-524252,255351,84,
260380,260448,2022-12-29_17-47-23-754798,260451,68,
265511,265538,2022-12-29_17-47-28-953035,265541,27,
270622,270643,2022-12-29_17-47-34-184801,270646,21,
275742,275764,2022-12-29_17-47-39-421521,275767,22,
280858,280879,2022-12-29_17-47-44-657630,280882,21,
285986,0,,291100,-285986,
291120,291178,2022-12-29_17-47-55-182407,291183,58,
296245,296265,2022-12-29_17-48-00-399211,296267,20,
301350,301370,2022-12-29_17-48-05-634125,301374,20,
306481,306561,2022-12-29_17-48-10-945085,306567,80,
311602,311654,2022-12-29_17-48-16-166211,311656,52,
316746,316766,2022-12-29_17-48-21-402865,316769,20,
321852,321872,2022-12-29_17-48-26-628296,321875,20,
326971,327052,2022-12-29_17-48-31-917581,327054,81,
332112,332192,2022-12-29_17-48-37-180338,332195,80,
337216,337275,2022-12-29_17-48-42-389507,337278,59,
342339,342361,2022-12-29_17-48-47-602924,342363,22,
347482,347503,2022-12-29_17-48-52-871821,347507,21,
352622,352668,2022-12-29_17-48-58-154232,352674,46,
357746,357766,2022-12-29_17-49-03-374595,357770,20,
362865,362960,2022-12-29_17-49-08-688233,362962,95,
367974,367995,2022-12-29_17-49-13-839105,367998,21,
373082,373103,2022-12-29_17-49-19-070234,373105,21,
378199,378260,2022-12-29_17-49-24-355918,378263,61,
383306,383364,2022-12-29_17-49-29-586116,383369,58,
388428,388462,2022-12-29_17-49-34-809270,388465,34,
393560,0,,398665,-393560,
398677,398706,2022-12-29_17-49-45-290040,398709,29,
403776,403798,2022-12-29_17-49-50-506653,403802,22,
408934,408971,2022-12-29_17-49-55-802910,408975,37,
414040,419239,2022-12-29_17-50-01-192108,419243,5199,
419243,424356,2022-12-29_17-50-06-508484,424359,5113,
424359,424382,2022-12-29_17-50-11-581705,424385,23,
429478,429499,2022-12-29_17-50-16-818791,429501,21,
434586,434613,2022-12-29_17-50-22-042484,434616,27,
439739,439787,2022-12-29_17-50-27-343955,439789,48,
444846,444881,2022-12-29_17-50-32-563219,444886,35,
449946,449967,2022-12-29_17-50-37-773969,449970,21,
455056,455082,2022-12-29_17-50-43-012143,455085,26,
460206,460282,2022-12-29_17-50-48-334410,460286,76,
465305,465326,2022-12-29_17-50-53-499207,465329,21,
470459,470489,2022-12-29_17-50-58-773145,470491,30,
475574,475607,2022-12-29_17-51-04-008085,475612,33,
480688,480794,2022-12-29_17-51-09-325271,485836,106,
485856,485904,2022-12-29_17-51-14-554634,485909,48,
490948,491008,2022-12-29_17-51-19-775289,491014,60,
496057,0,,501192,-496057,
501204,501224,2022-12-29_17-51-30-248597,501227,20,
506303,506325,2022-12-29_17-51-35-468791,506327,22,
511427,511449,2022-12-29_17-51-40-707050,511452,22,
516534,516570,2022-12-29_17-51-45-949363,516573,36,
521652,521695,2022-12-29_17-51-51-200640,521698,43,
526763,526810,2022-12-29_17-51-56-437021,526816,47,
531871,531918,2022-12-29_17-52-01-669221,531921,47,
536980,537019,2022-12-29_17-52-06-879481,537024,39,
542086,542111,2022-12-29_17-52-12-101366,542116,25,
547189,547209,2022-12-29_17-52-17-325984,547212,20,
552326,552349,2022-12-29_17-52-22-596824,552351,23,
557436,557500,2022-12-29_17-52-27-866436,557505,64,
562543,562605,2022-12-29_17-52-33-091842,562608,62,
567643,567664,2022-12-29_17-52-38-263769,567667,21,
572752,572773,2022-12-29_17-52-43-494358,572775,21,
577903,577925,2022-12-29_17-52-48-767958,577928,22,
583020,583042,2022-12-29_17-52-54-009568,583045,22,
588161,588259,2022-12-29_17-52-59-345292,588262,98,
593295,593337,2022-12-29_17-53-04-535554,593343,42,
598400,598428,2022-12-29_17-53-09-755424,598433,28,
603503,603522,2022-12-29_17-53-14-973713,603525,19,
608645,608711,2022-12-29_17-53-20-288435,608714,66,
613743,613815,2022-12-29_17-53-25-518877,613818,72,
618898,618918,2022-12-29_17-53-30-747430,618921,20,
624003,624033,2022-12-29_17-53-35-973343,624038,30,
629117,629210,2022-12-29_17-53-41-280558,629213,93,
634240,634260,2022-12-29_17-53-46-453090,634263,20,
639346,639368,2022-12-29_17-53-51-682897,639370,22,
644464,644545,2022-12-29_17-53-56-985480,644547,81,
649596,649644,2022-12-29_17-54-02-187858,649650,48,
654694,654720,2022-12-29_17-54-07-396187,654723,26,
659831,659854,2022-12-29_17-54-12-661594,659856,23,
664954,665028,2022-12-29_17-54-17-956456,665031,74,
670078,670146,2022-12-29_17-54-23-188015,670149,68,
675199,0,,680316,-675199,
680328,680373,2022-12-29_17-54-33-673253,680376,45,
685434,685528,2022-12-29_17-54-38-941301,685531,94,
690545,690567,2022-12-29_17-54-44-111029,690571,22,
695668,695707,2022-12-29_17-54-49-377397,695709,39,
700775,700811,2022-12-29_17-54-54-601508,700815,36,
705911,705938,2022-12-29_17-54-59-837612,705940,27,
711062,711157,2022-12-29_17-55-05-180278,711160,95,
716189,716236,2022-12-29_17-55-10-391771,716239,47,
721318,0,,721418,-721318,
726427,726532,2022-12-29_17-55-20-925060,731558,105,
731579,731648,2022-12-29_17-55-26-152858,731653,69,
736671,736737,2022-12-29_17-55-31-373077,736743,66,
741817,741843,2022-12-29_17-55-36-597226,741846,26,
746951,746973,2022-12-29_17-55-41-854124,746975,22,
752074,752147,2022-12-29_17-55-47-144216,752154,73,
757207,757229,2022-12-29_17-55-52-358286,757231,22,
762334,762356,2022-12-29_17-55-57-614623,762358,22,
767441,767462,2022-12-29_17-56-02-838548,767465,21,
772567,772661,2022-12-29_17-56-08-160712,772664,94,
777682,777702,2022-12-29_17-56-13-323048,777705,20,
782823,782843,2022-12-29_17-56-18-593927,782846,20,
787959,788033,2022-12-29_17-56-23-904206,788036,74,
793057,793078,2022-12-29_17-56-29-068698,793081,21,
798178,798269,2022-12-29_17-56-34-357636,798275,91,
803319,803342,2022-12-29_17-56-39-571784,803344,23,
808459,808481,2022-12-29_17-56-44-842113,808484,22,
813580,813638,2022-12-29_17-56-50-120050,813641,58,
818688,818744,2022-12-29_17-56-55-339900,818748,56,
823817,823859,2022-12-29_17-57-00-565867,823864,42,
828921,828944,2022-12-29_17-57-05-784842,828946,23,
834027,834142,2022-12-29_17-57-11-109648,839132,115,
839153,839244,2022-12-29_17-57-16-332586,839249,91,
844241,844261,2022-12-29_17-57-21-472096,844263,20,
849377,849447,2022-12-29_17-57-26-779081,849451,70,
854483,854554,2022-12-29_17-57-32-000624,854557,71,
859595,859662,2022-12-29_17-57-37-222322,859665,67,
864726,864753,2022-12-29_17-57-42-444563,864755,27,
869826,869853,2022-12-29_17-57-47-659339,869855,27,
874963,874984,2022-12-29_17-57-52-919929,874988,21,
880071,880091,2022-12-29_17-57-58-143610,880094,20,
885223,885243,2022-12-29_17-58-03-421237,885246,20,
890360,890379,2022-12-29_17-58-08-681294,890383,19,
895466,895486,2022-12-29_17-58-13-910426,895489,20,
900575,900659,2022-12-29_17-58-19-206462,900662,84,
905689,905765,2022-12-29_17-58-24-430987,905770,76,
910800,910851,2022-12-29_17-58-29-655028,910854,51,
915898,915920,2022-12-29_17-58-34-836676,915923,22,
921042,921067,2022-12-29_17-58-40-103236,921073,25,
926180,926201,2022-12-29_17-58-45-364628,926204,21,
931296,931349,2022-12-29_17-58-50-636467,931352,53,
936395,936416,2022-12-29_17-58-55-826667,936420,21,
941537,941560,2022-12-29_17-59-01-084402,941563,23,
946643,951813,2022-12-29_17-59-06-414446,951828,5170,
951846,951868,2022-12-29_17-59-11-635365,951871,22,
956926,956975,2022-12-29_17-59-16-863000,956980,49,
962033,962069,2022-12-29_17-59-22-081264,962071,36,
967141,967176,2022-12-29_17-59-27-307772,967181,35,
972249,972272,2022-12-29_17-59-32-530386,972275,23,
977351,977372,2022-12-29_17-59-37-750750,977374,21,
982498,982578,2022-12-29_17-59-43-076168,982584,80,
987605,987673,2022-12-29_17-59-48-300272,987675,68,
992714,992763,2022-12-29_17-59-53-518115,992768,49,
997826,997866,2022-12-29_17-59-58-735291,997869,40,
1002932,1002984,2022-12-29_18-00-03-979065,1002987,52,
1008058,1008082,2022-12-29_18-00-09-196112,1008085,24,
1013155,1018298,2022-12-29_18-00-14-511697,1018314,5143,
1018336,1018389,2022-12-29_18-00-19-736341,1018394,53,
1023410,1023471,2022-12-29_18-00-24-948592,1023474,61,
1028519,1028570,2022-12-29_18-00-30-179214,1028573,51,
1033631,1033688,2022-12-29_18-00-35-407197,1033693,57,
1038760,1038783,2022-12-29_18-00-40-623460,1038786,23,
1043867,1043888,2022-12-29_18-00-45-849292,1043891,21,
1048989,1049008,2022-12-29_18-00-51-101284,1049011,19,
1054106,1054168,2022-12-29_18-00-56-386330,1054171,62,
1059246,1059283,2022-12-29_18-01-01-619350,1059288,37,
1064376,1064471,2022-12-29_18-01-06-932337,1064473,95,
1069496,1069518,2022-12-29_18-01-12-099711,1069522,22,
1074603,1074624,2022-12-29_18-01-17-328468,1074627,21,
1079739,1079781,2022-12-29_18-01-22-601322,1079785,42,
1084845,1084892,2022-12-29_18-01-27-832658,1084897,47,
1089965,1089994,2022-12-29_18-01-33-051624,1089998,29,
1095094,1095118,2022-12-29_18-01-38-303639,1095121,24,
1100222,1100306,2022-12-29_18-01-43-607667,1100312,84,
1105365,1105392,2022-12-29_18-01-48-822527,1105395,27,
1110509,1110530,2022-12-29_18-01-54-077546,1110532,21,
1115645,1115738,2022-12-29_18-01-59-406116,1115741,93,
1120775,1120798,2022-12-29_18-02-04-600603,1120800,23,
1125903,1125926,2022-12-29_18-02-09-844792,1125929,23,
1131025,1131046,2022-12-29_18-02-15-084107,1131048,21,
1136134,1136156,2022-12-29_18-02-20-316968,1136159,22,
1141268,1141343,2022-12-29_18-02-25-637427,1141346,75,
1146372,1146402,2022-12-29_18-02-30-807971,1146408,30,
1151498,1151593,2022-12-29_18-02-36-124799,1151596,95,
1156611,1156632,2022-12-29_18-02-41-281852,1156635,21,
1161731,1161817,2022-12-29_18-02-46-586294,1161822,86,
1166849,1166900,2022-12-29_18-02-51-799891,1166903,51,
1171981,1172008,2022-12-29_18-02-57-022398,1172011,27,
1177117,1177144,2022-12-29_18-03-02-282857,1177147,27,
1182224,1182244,2022-12-29_18-03-07-508551,1182247,20,
1187333,1187354,2022-12-29_18-03-12-737348,1187357,21,
1192444,1192471,2022-12-29_18-03-17-971522,1192474,27,
1197597,1197636,2022-12-29_18-03-23-247966,1197642,39,
1202743,1202812,2022-12-29_18-03-28-563901,1202817,69,
1207877,1207929,2022-12-29_18-03-33-789747,1207935,52,
1213006,1213034,2022-12-29_18-03-39-026963,1213036,28,
1218123,1218219,2022-12-29_18-03-44-331583,1218225,96,
1223243,1223265,2022-12-29_18-03-49-503176,1223268,22,
1228373,1228421,2022-12-29_18-03-54-779376,1228424,48,
1233480,1233510,2022-12-29_18-03-59-988556,1233515,30,
1238620,1238640,2022-12-29_18-04-05-234382,1238643,20,
1243729,1243750,2022-12-29_18-04-10-469249,1243753,21,
1248849,1248870,2022-12-29_18-04-15-713022,1248873,21,
1253974,1254031,2022-12-29_18-04-20-994202,1254036,57,
1259105,1259153,2022-12-29_18-04-26-233622,1259156,48,
1264229,1264253,2022-12-29_18-04-31-462030,1264256,24,
1269336,1269357,2022-12-29_18-04-36-692766,1269360,21,
1274488,1274516,2022-12-29_18-04-41-979144,1274519,28,
1279628,1279649,2022-12-29_18-04-47-232534,1279652,21,
1284745,1284822,2022-12-29_18-04-52-529960,1284824,77,
1289845,1289872,2022-12-29_18-04-57-696806,1289874,27,
1294961,1295020,2022-12-29_18-05-02-976039,1295022,59,
1300070,1300130,2022-12-29_18-05-08-199996,1300133,60,
1305177,1305240,2022-12-29_18-05-13-422949,1305245,63,
1310286,1310334,2022-12-29_18-05-18-646855,1310337,48,
1315395,1315436,2022-12-29_18-05-23-869878,1315441,41,
1320522,0,,1320621,-1320522,
1325632,1325654,2022-12-29_18-05-34-330121,1325658,22,
1330747,1330824,2022-12-29_18-05-39-629093,1330827,77,
1335858,1335942,2022-12-29_18-05-44-862813,1335948,84,
1340977,1341039,2022-12-29_18-05-50-086000,1341046,62,
1346083,1346131,2022-12-29_18-05-55-305711,1346133,48,
1351191,1351233,2022-12-29_18-06-00-528039,1351237,42,
1356300,1356339,2022-12-29_18-06-05-758688,1356343,39,
1361406,1361432,2022-12-29_18-06-10-966670,1361434,26,
1366539,1366567,2022-12-29_18-06-16-218896,1366570,28,
1371653,1371733,2022-12-29_18-06-21-512863,1371736,80,
1376755,1376839,2022-12-29_18-06-26-740323,1376842,84,
1381872,1381923,2022-12-29_18-06-31-942897,1381925,51,
1386979,1387038,2022-12-29_18-06-37-179267,1387041,59,
1392086,1392151,2022-12-29_18-06-42-407380,1392156,65,
1397196,1397250,2022-12-29_18-06-47-630865,1397256,54,
1402307,1402361,2022-12-29_18-06-52-860002,1402366,54,
1407413,1407439,2022-12-29_18-06-58-069293,1407443,26,
1412553,1412574,2022-12-29_18-07-03-325179,1412577,21,
1417660,1417685,2022-12-29_18-07-08-548187,1417688,25,
1422818,1422847,2022-12-29_18-07-13-847970,1422851,29,
1427925,1427947,2022-12-29_18-07-19-069914,1427953,22,
1433037,1433057,2022-12-29_18-07-24-301584,1433060,20,
1438139,1438162,2022-12-29_18-07-29-521796,1438165,23,
1443243,1443264,2022-12-29_18-07-34-750711,1443267,21,
1448412,1448457,2022-12-29_18-07-40-062835,1448463,45,
1453519,1453555,2022-12-29_18-07-45-283264,1453557,36,
1458624,1458648,2022-12-29_18-07-50-497276,1458651,24,
1463758,1463781,2022-12-29_18-07-55-752479,1463784,23,
1468875,1468961,2022-12-29_18-08-01-053479,1468964,86,
1473984,1474004,2022-12-29_18-08-06-217857,1474008,20,
1479090,1479110,2022-12-29_18-08-11-443023,1479113,20,
1484199,1484220,2022-12-29_18-08-16-674872,1484224,21,
1489332,1489365,2022-12-29_18-08-21-942208,1489368,33,
1494433,1494457,2022-12-29_18-08-27-164776,1494460,24,
1499556,1499650,2022-12-29_18-08-32-482500,1499654,94,
1504682,1504702,2022-12-29_18-08-37-652079,1504705,20,
1509802,1509879,2022-12-29_18-08-42-939662,1509885,77,
1514935,1520036,2022-12-29_18-08-48-171227,1520047,5101,
1520065,1520089,2022-12-29_18-08-53-403552,1520092,24,
1525149,1530263,2022-12-29_18-08-58-704460,1530277,5114,
1530298,1530370,2022-12-29_18-09-03-925965,1530373,72,
1535431,1535506,2022-12-29_18-09-09-180636,1535509,75,
1540565,1540585,2022-12-29_18-09-14-387033,1540588,20,
1545699,1545719,2022-12-29_18-09-19-638514,1545722,20,
1550823,1550885,2022-12-29_18-09-24-924042,1550891,62,
1555959,1555995,2022-12-29_18-09-30-150256,1556000,36,
1561082,1561105,2022-12-29_18-09-35-392358,1561108,23,
1566199,1566269,2022-12-29_18-09-40-681436,1566272,70,
1571307,1571329,2022-12-29_18-09-45-861183,1571332,22,
1576419,1576446,2022-12-29_18-09-51-092894,1576449,27,
1581545,1581579,2022-12-29_18-09-56-352760,1581581,34,
1586683,1586703,2022-12-29_18-10-01-600526,1586706,20,
1591795,1591815,2022-12-29_18-10-06-831996,1591817,20,
1596924,1596995,2022-12-29_18-10-12-128590,1596998,71,
1602063,1602087,2022-12-29_18-10-17-351322,1602090,24,
1607185,1607208,2022-12-29_18-10-22-592766,1607211,23,
1612333,1612394,2022-12-29_18-10-27-897994,1612398,61,
1617469,1617489,2022-12-29_18-10-33-113402,1617492,20,
1622595,1622617,2022-12-29_18-10-38-368640,1622619,22,
1627721,1627809,2022-12-29_18-10-43-689386,1627812,88,
1632833,1632854,2022-12-29_18-10-48-848866,1632858,21,
1637940,1637993,2022-12-29_18-10-54-110453,1637995,53,
1643073,1643096,2022-12-29_18-10-59-335814,1643100,23,
1648179,1648199,2022-12-29_18-11-04-565675,1648202,20,
1653299,1653323,2022-12-29_18-11-09-800927,1653327,24,
1658412,1658491,2022-12-29_18-11-15-095515,1658493,79,
1663539,1663561,2022-12-29_18-11-20-286960,1663565,22,
1668654,1668674,2022-12-29_18-11-25-519080,1668677,20,
1673770,1673807,2022-12-29_18-11-30-771026,1673813,37,
1678902,1678924,2022-12-29_18-11-36-013264,1678926,22,
1684022,1684115,2022-12-29_18-11-41-329300,1684119,93,
1689138,1689226,2022-12-29_18-11-46-548274,1689231,88,
1694236,1694258,2022-12-29_18-11-51-711080,1694261,22,
1699350,1699439,2022-12-29_18-11-57-011281,1699442,89,
1704452,1704498,2022-12-29_18-12-02-196981,1704501,46,
1709568,1709636,2022-12-29_18-12-07-442395,1709641,68,
1714677,1714704,2022-12-29_18-12-12-646816,1714707,27,
1719785,1719805,2022-12-29_18-12-17-875589,1719808,20,
1724913,1724935,2022-12-29_18-12-23-129364,1724939,22,
1730029,1730096,2022-12-29_18-12-28-411189,1730100,67,
1735138,1735210,2022-12-29_18-12-33-637172,1735213,72,
1740245,1740309,2022-12-29_18-12-38-859163,1740311,64,
1745380,1745421,2022-12-29_18-12-44-097773,1745424,41,
1750478,1750499,2022-12-29_18-12-49-297254,1750502,21,
1755596,1760712,2022-12-29_18-12-54-637488,1760720,5116,
1760739,1760759,2022-12-29_18-12-59-796044,1760762,20,
1765827,1765849,2022-12-29_18-13-05-011795,1765852,22,
1770989,1771023,2022-12-29_18-13-10-307336,1771029,34,
1776096,1776117,2022-12-29_18-13-15-530597,1776121,21,
1781202,1781223,2022-12-29_18-13-20-753857,1781226,21,
1786339,1786358,2022-12-29_18-13-26-013142,1786362,19,
1791452,1791514,2022-12-29_18-13-31-297577,1791517,62,
1796561,1796615,2022-12-29_18-13-36-521891,1796619,54,
1801671,1801719,2022-12-29_18-13-41-742979,1801722,48,
1806769,1806790,2022-12-29_18-13-46-927236,1806793,21,
1811924,1811946,2022-12-29_18-13-52-203248,1811949,22,
1817031,1817051,2022-12-29_18-13-57-435661,1817053,20,
1822158,1822227,2022-12-29_18-14-02-737138,1822229,69,
1827260,1827337,2022-12-29_18-14-07-958135,1827341,77,
1832373,1832434,2022-12-29_18-14-13-181201,1832438,61,
1837480,1837549,2022-12-29_18-14-18-403401,1837555,69,
1842588,1842640,2022-12-29_18-14-23-625489,1842644,52,
1847711,1847734,2022-12-29_18-14-28-847473,1847738,23,
1852827,1852939,2022-12-29_18-14-34-174082,1857960,112,
1857972,1857992,2022-12-29_18-14-39-345744,1857994,20,
1863079,1863137,2022-12-29_18-14-44-618118,1863140,58,
1868177,1868199,2022-12-29_18-14-49-806403,1868201,22,
1873322,1873345,2022-12-29_18-14-55-072806,1873348,23,
1878436,1878544,2022-12-29_18-15-00-389392,1883555,108,
1883577,1883643,2022-12-29_18-15-05-611107,1883646,66,
1888660,1888682,2022-12-29_18-15-10-771885,1888685,22,
1893777,1893834,2022-12-29_18-15-16-045811,1893837,57,
1898894,1898958,2022-12-29_18-15-21-282890,1898961,64,
1904028,1904048,2022-12-29_18-15-26-507512,1904052,20,
1909156,1909176,2022-12-29_18-15-31-751822,1909180,20,
1914278,1914299,2022-12-29_18-15-36-999576,1914302,21,
1919394,1919447,2022-12-29_18-15-42-270487,1919450,53,
1924530,1924576,2022-12-29_18-15-47-523189,1924579,46,
1929668,1929689,2022-12-29_18-15-52-753853,1929692,21,
1934785,1934812,2022-12-29_18-15-57-999780,1934815,27,
1939922,1939943,2022-12-29_18-16-03-264186,1939946,21,
1945054,1945138,2022-12-29_18-16-08-578248,1945141,84,
1950162,1950240,2022-12-29_18-16-13-801142,1950244,78,
1955293,1955359,2022-12-29_18-16-19-033831,1955364,66,
1960402,1960456,2022-12-29_18-16-24-255039,1960459,54,
1965543,1970659,2022-12-29_18-16-29-682138,1970662,5116,
1970662,1970756,2022-12-29_18-16-34-803740,1970760,94,
1975798,1975858,2022-12-29_18-16-40-027254,1975864,60,
1980941,1980973,2022-12-29_18-16-45-257262,1980978,32,
1986052,1986072,2022-12-29_18-16-50-489231,1986075,20,
1991172,1991247,2022-12-29_18-16-55-779144,1991250,75,
1996280,1996302,2022-12-29_18-17-00-963023,1996305,22,
2001419,2001445,2022-12-29_18-17-06-231185,2001449,26,
2006559,2006645,2022-12-29_18-17-11-555738,2006649,86,
2011675,2011696,2022-12-29_18-17-16-724076,2011699,21,
2016822,2016863,2022-12-29_18-17-22-011538,2016869,41,
2021930,2021964,2022-12-29_18-17-27-226090,2021968,34,
2027058,0,,2027158,-2027058,
2032167,2032187,2022-12-29_18-17-37-701866,2032190,20,
2037285,2037357,2022-12-29_18-17-42-994981,2037361,72,
2042398,2042418,2022-12-29_18-17-48-169410,2042421,20,
2047512,2047533,2022-12-29_18-17-53-403118,2047537,21,
2052638,2052661,2022-12-29_18-17-58-657367,2052664,23,
2057751,2057782,2022-12-29_18-18-03-897748,2057787,31,
2062894,2062917,2022-12-29_18-18-09-152718,2062919,23,
2068016,2068090,2022-12-29_18-18-14-443422,2068095,74,
2073152,2073173,2022-12-29_18-18-19-666456,2073176,21,
2078261,2078283,2022-12-29_18-18-24-899831,2078286,22,
2083382,2083402,2022-12-29_18-18-30-132631,2083404,20,
2088493,2088571,2022-12-29_18-18-35-429803,2088574,78,
2093636,2093668,2022-12-29_18-18-40-654040,2093671,32,
2098744,2098767,2022-12-29_18-18-45-875252,2098770,23,
2103868,2103890,2022-12-29_18-18-51-115082,2103893,22,
2108970,2108989,2022-12-29_18-18-56-327709,2108992,19,
2114109,2114186,2022-12-29_18-19-01-648570,2114191,77,
2119216,2119282,2022-12-29_18-19-06-870640,2119285,66,
2124325,2124383,2022-12-29_18-19-12-095016,2124386,58,
2129476,2129498,2022-12-29_18-19-17-329307,2129501,22,
2134592,2134611,2022-12-29_18-19-22-565316,2134614,19,
2139705,2139726,2022-12-29_18-19-27-805876,2139729,21,
2144859,2144882,2022-12-29_18-19-33-082175,2144885,23,
2150010,2150077,2022-12-29_18-19-38-408410,2150080,67,
2155116,2155136,2022-12-29_18-19-43-587705,2155139,20,
2160235,2160288,2022-12-29_18-19-48-856180,2160293,53,
2165343,2165389,2022-12-29_18-19-54-073947,2165394,46,
2170450,2170484,2022-12-29_18-19-59-296703,2170488,34,
2175557,2175587,2022-12-29_18-20-04-519267,2175590,30,
2180690,2180712,2022-12-29_18-20-09-768123,2180714,22,
2185805,2185826,2022-12-29_18-20-15-000955,2185829,21,
2190959,2190989,2022-12-29_18-20-20-283342,2190992,30,
2196065,2196089,2022-12-29_18-20-25-511624,2196092,24,
2201206,2201228,2022-12-29_18-20-30-765534,2201230,22,
2206313,2206334,2022-12-29_18-20-35-997152,2206337,21,
2211460,2211493,2022-12-29_18-20-41-276072,2211496,33,
2216567,2216591,2022-12-29_18-20-46-505509,2216594,24,
2221722,2221786,2022-12-29_18-20-51-821561,2221788,64,
2226821,2226894,2022-12-29_18-20-57-050856,2226898,73,
2231967,2231994,2022-12-29_18-21-02-273715,2231997,27,
2237067,2237091,2022-12-29_18-21-07-497705,2237094,24,
2242174,0,,2247279,-2242174,
2247291,2247313,2022-12-29_18-21-17-964499,2247316,22,
2252402,2252424,2022-12-29_18-21-23-189349,2252427,22,
2257549,2257594,2022-12-29_18-21-28-483206,2257597,45,
2262655,2262686,2022-12-29_18-21-33-705777,2262689,31,
2267824,2267844,2022-12-29_18-21-38-980504,2267848,20,
2272932,2273001,2022-12-29_18-21-44-258040,2273003,69,
2278040,2278062,2022-12-29_18-21-49-433452,2278064,22,
2283147,2283168,2022-12-29_18-21-54-668844,2283170,21,
2288265,2288296,2022-12-29_18-21-59-918324,2288299,31,
2293405,2293425,2022-12-29_18-22-05-165719,2293428,20,
2298535,2298602,2022-12-29_18-22-10-467293,2298612,67,
2303642,2303710,2022-12-29_18-22-15-699165,2303715,68,
2308750,2308808,2022-12-29_18-22-20-922121,2308811,58,
2313863,2313907,2022-12-29_18-22-26-142575,2313912,44,
2318990,2319011,2022-12-29_18-22-31-366773,2319013,21,
2324112,2324212,2022-12-29_18-22-36-681803,2324215,100,
2329226,2329246,2022-12-29_18-22-41-844161,2329249,20,
2334370,2334391,2022-12-29_18-22-47-104367,2334395,21,
2339487,2339523,2022-12-29_18-22-52-360422,2339528,36,
2344594,2344625,2022-12-29_18-22-57-577643,2344629,31,
2349697,2349723,2022-12-29_18-23-02-795083,2349726,26,
2354820,2354840,2022-12-29_18-23-08-040542,2354843,20,
2359940,2359962,2022-12-29_18-23-13-280972,2359965,22,
2365063,2365084,2022-12-29_18-23-18-520155,2365086,21,
2370170,2370227,2022-12-29_18-23-23-792502,2370230,57,
2375304,2375331,2022-12-29_18-23-29-019873,2375336,27,
2380415,2380439,2022-12-29_18-23-34-254021,2380442,24,
2385526,2385621,2022-12-29_18-23-39-554147,2385624,95,
2390635,2390657,2022-12-29_18-23-44-707886,2390660,22,
2395759,2395829,2022-12-29_18-23-50-010947,2395831,70,
2400902,2400924,2022-12-29_18-23-55-224546,2400927,22,
2406013,2406034,2022-12-29_18-24-00-456089,2406037,21,
2411124,2411145,2022-12-29_18-24-05-679561,2411148,21,
2416262,2416342,2022-12-29_18-24-11-006608,2416344,80,
2421373,2421395,2022-12-29_18-24-16-179194,2421397,22,
2426496,2426546,2022-12-29_18-24-21-448742,2426551,50,
2431617,2431639,2022-12-29_18-24-26-663459,2431642,22,
2436744,2436765,2022-12-29_18-24-31-914071,2436768,21,
2441852,2441872,2022-12-29_18-24-37-146309,2441874,20,
2447047,2447137,2022-12-29_18-24-42-540462,2447142,90,
2452178,2452240,2022-12-29_18-24-47-763893,2452243,62,
2457316,2457338,2022-12-29_18-24-52-983719,2457341,22,
2462439,2462461,2022-12-29_18-24-58-228584,2462464,22,
2467551,2467572,2022-12-29_18-25-03-458857,2467575,21,
2472687,2472741,2022-12-29_18-25-08-758774,2472744,54,
2477829,2477852,2022-12-29_18-25-13-990198,2477855,23,
2482949,2482969,2022-12-29_18-25-19-226511,2482971,20,
2488079,2488146,2022-12-29_18-25-24-517721,2488149,67,
2493190,2493213,2022-12-29_18-25-29-708167,2493216,23,
2498338,2498359,2022-12-29_18-25-34-982616,2498362,21,
2503446,2503469,2022-12-29_18-25-40-213872,2503472,23,
2508580,2508656,2022-12-29_18-25-45-521030,2508662,76,
2513716,2513758,2022-12-29_18-25-50-742508,2513761,42,
2518856,2518951,2022-12-29_18-25-56-055527,2518954,95,
2523967,2523989,2022-12-29_18-26-01-213483,2523992,22,
2529083,2529145,2022-12-29_18-26-06-501323,2529147,62,
2534192,2534244,2022-12-29_18-26-11-723234,2534247,52,
2539291,2544440,2022-12-29_18-26-17-065425,2544443,5149,
2544444,2544466,2022-12-29_18-26-22-175121,2544470,22,
2549608,2549660,2022-12-29_18-26-27-495057,2549663,52,
2554734,2554758,2022-12-29_18-26-32-723044,2554761,24,
2559846,2559866,2022-12-29_18-26-37-946783,2559869,20,
2564947,2564970,2022-12-29_18-26-43-168999,2564973,23,
2570092,2570111,2022-12-29_18-26-48-431065,2570114,19,
2575247,2575272,2022-12-29_18-26-53-719743,2575275,25,
2580383,2580406,2022-12-29_18-26-58-967520,2580408,23,
2585516,2585584,2022-12-29_18-27-04-264449,2585589,68,
2590623,2590684,2022-12-29_18-27-09-492362,2590687,61,
2595732,2595784,2022-12-29_18-27-14-716425,2595787,52,
2600840,2600864,2022-12-29_18-27-19-921832,2600867,24,
2605974,2605994,2022-12-29_18-27-25-173814,2605996,20,
2611082,2611102,2022-12-29_18-27-30-404624,2611105,20,
2616189,2616279,2022-12-29_18-27-35-701326,2616285,90,
2621304,2621325,2022-12-29_18-27-40-874085,2621328,21,
2626421,2626485,2022-12-29_18-27-46-144765,2626490,64,
2631533,2631575,2022-12-29_18-27-51-363351,2631578,42,
2636640,2636689,2022-12-29_18-27-56-590158,2636692,49,
2641745,2641766,2022-12-29_18-28-01-793835,2641769,21,
2646853,2646886,2022-12-29_18-28-07-039641,2646889,33,
2651990,2652010,2022-12-29_18-28-12-285301,2652013,20,
2657101,2657128,2022-12-29_18-28-17-513226,2657131,27,
2662216,2662286,2022-12-29_18-28-22-797443,2662289,70,
2667323,2667395,2022-12-29_18-28-28-028229,2667400,72,
2672433,2672483,2022-12-29_18-28-33-249893,2672486,50,
2677541,2677584,2022-12-29_18-28-38-471998,2677589,43,
2682650,2682689,2022-12-29_18-28-43-700960,2682698,39,
2687942,2687985,2022-12-29_18-28-49-123901,2687987,43,
2693041,2693062,2022-12-29_18-28-54-316251,2693066,21,
2698174,2698195,2022-12-29_18-28-59-573315,2698199,21,
2703281,2703307,2022-12-29_18-29-04-806998,2703310,26,
2708422,2708448,2022-12-29_18-29-10-077453,2708451,26,
2713540,2713593,2022-12-29_18-29-15-337204,2713596,53,
2718671,2718697,2022-12-29_18-29-20-565088,2718701,26,
2723780,2723806,2022-12-29_18-29-25-786799,2723809,26,
2728910,2728930,2022-12-29_18-29-31-040156,2728934,20,
2734017,2734039,2022-12-29_18-29-36-272943,2734042,22,
2739135,2739195,2022-12-29_18-29-41-554543,2739199,60,
2744247,2744271,2022-12-29_18-29-46-752325,2744274,24,
2749372,2749399,2022-12-29_18-29-52-000088,2749402,27,
2754478,2754500,2022-12-29_18-29-57-222331,2754504,22,
2759589,2759611,2022-12-29_18-30-02-458594,2759614,22,
2764692,2764712,2022-12-29_18-30-07-691140,2764715,20,
2769800,2769890,2022-12-29_18-30-12-988951,2769895,90,
2774917,2775004,2022-12-29_18-30-18-217129,2775009,87,
2780041,2780146,2022-12-29_18-30-23-475558,2780149,105,
2785185,2785208,2022-12-29_18-30-28-669311,2785211,23,
2790293,2790315,2022-12-29_18-30-33-895077,2790318,22,
2795437,2795499,2022-12-29_18-30-39-198564,2795502,62,
2800567,2800615,2022-12-29_18-30-44-436851,2800618,48,
2805692,2805716,2022-12-29_18-30-49-661374,2805719,24,
2810807,2810828,2022-12-29_18-30-54-902464,2810831,21,
2815932,2816010,2022-12-29_18-31-00-201438,2816016,78,
2821042,2821101,2022-12-29_18-31-05-412557,2821104,59,
2826164,2826213,2022-12-29_18-31-10-645398,2826218,49,
2831318,2831395,2022-12-29_18-31-15-958152,2831397,77,
2836447,2836501,2022-12-29_18-31-21-192154,2836504,54,
2841566,2841586,2022-12-29_18-31-26-403161,2841591,20,
2846697,2846717,2022-12-29_18-31-31-655650,2846720,20,
2851806,2851833,2022-12-29_18-31-36-880738,2851836,27,
2856936,2856957,2022-12-29_18-31-42-133823,2856960,21,
2862032,2862097,2022-12-29_18-31-47-403778,2862100,65,
2867187,2867208,2022-12-29_18-31-52-638174,2867212,21,
2872297,2872329,2022-12-29_18-31-57-860433,2872334,32,
2877408,2877427,2022-12-29_18-32-03-093095,2877430,19,
2882533,2882553,2022-12-29_18-32-08-345946,2882557,20,
2887656,2887697,2022-12-29_18-32-13-614250,2887700,41,
2892785,2892807,2022-12-29_18-32-18-841711,2892810,22,
2897898,2897922,2022-12-29_18-32-24-076330,2897926,24,
2903014,2903035,2022-12-29_18-32-29-319542,2903038,21,
2908136,2908213,2022-12-29_18-32-34-620150,2908218,77,
2913253,2913278,2022-12-29_18-32-39-814613,2913281,25,
2918371,2918394,2022-12-29_18-32-45-054426,2918398,23,
2923498,2923520,2022-12-29_18-32-50-299054,2923524,22,
2928605,2928628,2022-12-29_18-32-55-525479,2928631,23,
2933733,2933813,2022-12-29_18-33-00-828945,2933819,80,
2938874,2938896,2022-12-29_18-33-06-042499,2938899,22,
2943999,2944094,2022-12-29_18-33-11-365319,2944097,95,
2949116,2949143,2022-12-29_18-33-16-522302,2949146,27,
2954240,2954310,2022-12-29_18-33-21-810500,2954312,70,
2959346,2959408,2022-12-29_18-33-27-041412,2959410,62,
2964487,2964511,2022-12-29_18-33-32-272008,2964514,24,
2969601,2969621,2022-12-29_18-33-37-497258,2969624,20,
2974732,2974753,2022-12-29_18-33-42-753461,2974756,21,
2979887,2979921,2022-12-29_18-33-48-037696,2979925,34,
2984993,2985015,2022-12-29_18-33-53-267510,2985018,22,
2990127,2990219,2022-12-29_18-33-58-585628,2990224,92,
2995254,2995275,2022-12-29_18-34-03-767418,2995278,21,
3000376,3000421,2022-12-29_18-34-09-028567,3000428,45,
3005484,3005505,2022-12-29_18-34-14-238729,3005508,21,
3010630,3010731,2022-12-29_18-34-19-584136,3010736,101,
3015753,3015814,2022-12-29_18-34-24-797722,3015818,61,
3020862,3020927,2022-12-29_18-34-30-021453,3020932,65,
3025969,3026033,2022-12-29_18-34-35-241205,3026038,64,
3031078,3031126,2022-12-29_18-34-40-464055,3031129,48,
3036185,3036214,2022-12-29_18-34-45-683687,3036217,29,
3041293,3041320,2022-12-29_18-34-50-906766,3041324,27,
3046429,3046517,2022-12-29_18-34-56-224662,3046520,88,
3051533,3051560,2022-12-29_18-35-01-382062,3051563,27,
3056642,3056663,2022-12-29_18-35-06-624147,3056666,21,
3061796,3061819,2022-12-29_18-35-11-898787,3061825,23,
3066894,3066945,2022-12-29_18-35-17-146963,3066948,51,
3072022,3077175,2022-12-29_18-35-22-550333,3077180,5153,
3077180,3077222,2022-12-29_18-35-27-671679,3077226,42,
3082323,3082346,2022-12-29_18-35-32-912472,3082350,23,
3087464,3087485,2022-12-29_18-35-38-167922,3087487,21,
3092580,3092634,2022-12-29_18-35-43-440277,3092639,54,
3097689,3097752,2022-12-29_18-35-48-670785,3097757,63,
3102788,3102809,2022-12-29_18-35-53-861610,3102812,21,
3107905,3107936,2022-12-29_18-35-59-106207,3107938,31,
3113058,3113079,2022-12-29_18-36-04-372230,3113082,21,
3118210,3118231,2022-12-29_18-36-09-645731,3118234,21,
3123373,3123444,2022-12-29_18-36-14-987144,3123448,71,
3128479,3128541,2022-12-29_18-36-20-204603,3128546,62,
3133592,3133626,2022-12-29_18-36-25-415678,3133629,34,
3138691,3138741,2022-12-29_18-36-30-647391,3138744,50,
3143808,3143848,2022-12-29_18-36-35-869205,3143851,40,
3148915,3148959,2022-12-29_18-36-41-099694,3148964,44,
3154019,3154139,2022-12-29_18-36-46-417226,3159143,120,
3159155,3159241,2022-12-29_18-36-51-638513,3159244,86,
3164260,3164281,2022-12-29_18-36-56-787287,3164284,21,
3169407,3169428,2022-12-29_18-37-02-058015,3169431,21,
3174532,3174553,2022-12-29_18-37-07-306441,3174556,21,
3179636,3179658,2022-12-29_18-37-12-535176,3179661,22,
3184792,3184813,2022-12-29_18-37-17-811313,3184815,21,
3189930,3189969,2022-12-29_18-37-23-082400,3189974,39,
3195058,3195080,2022-12-29_18-37-28-320231,3195082,22,
3200181,3200262,2022-12-29_18-37-33-626978,3200267,81,
3205311,3205346,2022-12-29_18-37-38-845389,3205349,35,
3210566,3210650,2022-12-29_18-37-44-272484,3210659,84,
3215668,3215689,2022-12-29_18-37-49-426685,3215692,21,
3220788,3220809,2022-12-29_18-37-54-668598,3220812,21,
3225912,3225932,2022-12-29_18-37-59-915776,3225936,20,
3231038,3231060,2022-12-29_18-38-05-169677,3231062,22,
3236169,3236190,2022-12-29_18-38-10-409197,3236193,21,
3241276,3241297,2022-12-29_18-38-15-642833,3241300,21,
3246392,3246413,2022-12-29_18-38-20-885627,3246416,21,
3251529,3251568,2022-12-29_18-38-26-161280,3251571,39,
3256678,3256697,2022-12-29_18-38-31-407820,3256700,19,
3261798,3261881,2022-12-29_18-38-36-710743,3261887,83,
3266939,3266960,2022-12-29_18-38-41-924552,3266964,21,
3272153,3272173,2022-12-29_18-38-47-264400,3272176,20,
3277260,3277279,2022-12-29_18-38-52-485857,3277282,19,
3282368,3282463,2022-12-29_18-38-57-789098,3282466,95,
3287476,3287497,2022-12-29_18-39-02-956871,3287500,21,
3292631,3292657,2022-12-29_18-39-08-237422,3292661,26,
3297743,3297801,2022-12-29_18-39-13-503195,3297804,58,
3302892,3302976,2022-12-29_18-39-18-792281,3302980,84,
3308063,3308085,2022-12-29_18-39-24-029327,3308088,22,
3313165,3313185,2022-12-29_18-39-29-256510,3313189,20,
3318273,3318294,2022-12-29_18-39-34-488996,3318297,21,
3323389,3323458,2022-12-29_18-39-39-773783,3323461,69,
3328519,3328542,2022-12-29_18-39-44-970741,3328545,23,
3333658,3333678,2022-12-29_18-39-50-233156,3333681,20,
3338805,3338879,2022-12-29_18-39-55-558929,3338884,74,
3343912,3343955,2022-12-29_18-40-00-767407,3343957,43,
3349054,3349083,2022-12-29_18-40-06-003126,3349088,29,
3354181,3354204,2022-12-29_18-40-11-248550,3354207,23,
3359298,3359388,2022-12-29_18-40-16-550026,3359393,90,
3364430,3364479,2022-12-29_18-40-21-772354,3364484,49,
3369559,3369579,2022-12-29_18-40-26-987853,3369582,20,
3374665,3374688,2022-12-29_18-40-32-216393,3374692,23,
3379777,3379798,2022-12-29_18-40-37-448757,3379801,21,
3384906,3384989,2022-12-29_18-40-42-763951,3384995,83,
3390016,3390038,2022-12-29_18-40-47-933593,3390042,22,
3395135,3395216,2022-12-29_18-40-53-213221,3395221,81,
3400249,3400295,2022-12-29_18-40-58-431068,3400300,46,
3405357,3405393,2022-12-29_18-41-03-653269,3405398,36,
3410455,3410476,2022-12-29_18-41-08-862532,3410479,21,
3415602,3415667,2022-12-29_18-41-14-175093,3415670,65,